*ta/de	pronoun	ὅδε
me\n	particle	μέν
*persw=n	noun	Πέρσης/Ρέρσης/πέρσης
tw=n	article	ὁ/ὅς
oi)xome/nwn	verb	οἴχομαι
*(ella/d'	noun	Ἑλλάς
e)s	preposition	εἰς
ai)=an	noun	αἶα
pista\	adjective	πιστός
kalei=tai	verb	καλέω
,	SENT	,
kai\	conjunction	???/καί
tw=n	article	ὁ/ὅς
a)fnew=n	adjective	ἀφνειός
kai\	conjunction	???/καί
poluxru/swn	adjective	πολύχρυσος
e(dra/nwn	noun	ἕδρανον
fu/lakes	noun	φύλαξ
,	SENT	,
kata\	preposition	κατά
presbei/an	noun	πρεσβεία
ou(\s	pronoun	ὁ/ὅς
au)to\s	adjective	αὐτός
a)/nac	noun	ἄναξ
*ce/rchs	proper	Ξέρξης
basileu\s	noun	βασιλεύς
*dareiogenh\s	adjective	Δαρειογενής
ei(/leto	verb	αἱρέω
xw/ras	noun	χώρα
e)foreu/ein	verb	ἐφορεύω
.	SENT	.
a)mfi\	preposition	ἀμφί
de\	particle	μηδέ/δέ/οὐδέ
no/stw|	noun	νόστος
tw=|	article	ὁ
basilei/w|	noun	βασίλειον
kai\	conjunction	???/καί
poluxru/sou	adjective	πολύχρυσος
stratia=s	noun	στρατία/στρατιά
h)/dh	adverb	ἠδή/ἤδη/ἦδη
kako/mantis	noun	κακόμαντις
a)/gan	adverb	ἄγαν
o)rsolopei=tai	verb	ὀρσολοπεύω/ὀρσολοπέω
qumo\s	noun	θυμός
e)/swqen	adverb	ἔσωθεν
.	SENT	.
pa=sa	pronoun	πᾶς
ga\r	particle	γάρ
i)sxu\s	noun	ἰσχύς
*)asiatogenh\s	adjective	Ἀσιατογενής
w)/|xwke	verb	οἴχομαι
,	SENT	,
ne/on	adjective	νέος
d'	particle	οὐδέ/δέ/??
a)/ndra	noun	ἀνήρ
bau/+zei	verb	βαύζω
,	SENT	,
kou)/te	adverb	οὔτε
tis	pronoun	τις/τίς/τὶς
a)/ggelos	noun	ἄγγελος
ou)/	adverb	οὔπως/οὔτι/οὔτε/οὐ
te	adverb	τε/οὔτε
tis	pronoun	τις/τίς/τὶς
i(ppeu\s	noun	ἱππεύς
a)/stu	noun	ἄστυ
to\	article	ὁ
*persw=n	noun	Πέρσης/Ρέρσης/πέρσης
a)fiknei=tai	verb	ἀφικνέομαι
:	SENT	:
oi(/te	pronoun	ὅστε
to\	article	ὁ
*sou/swn	proper	Σοῦσος/Σοῦσα
h)d'	conjunction	ἠδέ/ἠδη
*)agbata/nwn	proper	Ἀγβάτανα
kai\	conjunction	???/καί
to\	article	ὁ
palaio\n	adjective	παλαιός
*ki/ssion	adjective	Κίσσιος
e(/rkos	noun	ἕρκος
prolipo/ntes	verb	προλείπω
e)/ban	verb	βαίνω
,	SENT	,
toi\	pronoun	ὁ//σύ/ὅς
me\n	particle	μέν
e)f'	preposition	ἐπί
i(/ppwn	noun	ἵππος
,	SENT	,
toi\	pronoun	ὁ//σύ/ὅς
d'	particle	οὐδέ/δέ/??
e)pi\	preposition	ἐπί
naw=n	noun	ναῦς/ναός
,	SENT	,
pezoi/	adjective	πεζός
te	particle	τε/??/οὔτε
ba/dhn	adverb	βάδην
pole/mou	noun	πολεμός/πόλεμος
sti=fos	noun	στῖφος
pare/xontes	verb	παρέχω
:	SENT	:
oi(=os	adjective	οἷος#1/οἷος
*)ami/strhs	noun	ἀμίστρης
h)d'	conjunction	ἠδέ/ἠδη
*)artafre/nhs	proper	Ἀρταφρένης
kai\	conjunction	???/καί
*megaba/ths	proper	Μεγαβάτης
h)d'	conjunction	ἠδέ/ἠδη
*)asta/sphs	noun	ἀστασπης
,	SENT	,
tagoi\	noun	ταγός
*persw=n	noun	Πέρσης/Ρέρσης/πέρσης
,	SENT	,
basilh=s	noun	βασιλεύς
basile/ws	noun	βασιλεύς
u(/poxoi	adjective	ὕποχος
mega/lou	adjective	μέγας
,	SENT	,
sou=ntai	verb	σεύω/σέω
,	SENT	,
stratia=s	noun	στρατία/στρατιά
pollh=s	adjective	πολύς
e)/foroi	noun	ἔφορος
,	SENT	,
tocoda/mante/s	noun	τοξοδάμας
t'	particle	τε
h)d'	conjunction	ἠδέ/ἠδη
i(ppoba/tai	noun	ἱπποβάτης
,	SENT	,
foberoi\	adjective	φοβερός
me\n	particle	μέν
i)dei=n	verb	ἰδέω/εἶδον/ὁράω
,	SENT	,
deinoi\	adjective	δεινός
de\	particle	μηδέ/δέ/οὐδέ
ma/xhn	noun	μαχή/μάχη
yuxh=s	noun	ψυχή
eu)tlh/moni	adjective	εὐτλήμων
do/ch|	noun	δόξις/δόξα
:	SENT	:
*)artemba/rhs	noun	Ἀρτεμβάρας/Ἀρτεμβάρης
q'	particle	τε
i(ppioxa/rmhs	noun	ἱππιοχάρμης
kai\	conjunction	???/καί
*masi/strhs	noun	μασίστρης
,	SENT	,
o(/	pronoun	/ὅ/ὅστις/ὁς/ὅς/ὁ
te	particle	τε/??/οὔτε
tocoda/mas	adjective	τοξόδαμνος
e)sqlo\s	adjective	ἐσθλός
*)imai=os	noun	Ἰμαῖος
,	SENT	,
*faranda/khs	noun	Φαρανδάκης
q'	particle	τε
,	SENT	,
i(/ppwn	noun	ἵππος
t'	particle	τε
e)lath\r	noun	ἐλατήρ
*sosqa/nhs	noun	Σοσθάνης
.	SENT	.
a)/llous	pronoun	ἄλλος
d'	particle	οὐδέ/δέ/??
o(	article	ὁ
me/gas	adjective	μέγας
kai\	conjunction	???/καί
poluqre/mmwn	adjective	πολυθρέμμων
*nei=los	noun	Νεῖλος
e)/pemyen	verb	πέμπω
:	SENT	:
*sousiska/nhs	noun	Σουσισκάνης
,	SENT	,
*phgastagw\n	noun	Πηγασταγών
*ai)guptogenh/s	adjective	Αἰγυπτογενής
,	SENT	,
o(/	pronoun	/ὅ/ὅστις/ὁς/ὅς/ὁ
te	particle	τε/??/οὔτε
th=s	article	ὁ
i(era=s	adjective	ἱερός/ἱερεύς
*me/mfidos	noun	Μέμφις
a)/rxwn	noun	ἄρχων
me/gas	adjective	μέγας
*)arsa/mhs	noun	Αρσάμης/Ἀρσάμης
,	SENT	,
ta/s	article	ὁ
t'	particle	τε
w)gugi/ous	adjective	̓ὠγύγιος/ὠγύγιος
*qh/bas	noun	Θῆβαι/Θήβη
e)fe/pwn	verb	ἐφέπω
*)ario/mardos	noun	Ἀριόμαρδος
,	SENT	,
kai\	conjunction	???/καί
e(leioba/tai	adjective	ἑλειοβάτης
naw=n	noun	ναῦς/ναός
e)re/tai	noun	ἐρέτης
deinoi\	adjective	δεινός
plh=qo/s	noun	πλῆθος
t'	particle	τε
a)na/riqmoi	adjective	ἀνάριθμος
.	SENT	.
a(brodiai/twn	adjective	ἁβροδίαιτος
d'	particle	οὐδέ/δέ/??
e(/petai	verb	ἕπομαι
*ludw=n	noun	Λυδός
o)/xlos	noun	ὄχλος
,	SENT	,
oi(/	pronoun	ὁ/ὅς/ἕ
t'	particle	τε
e)pi/pan	adverb	ἐπίπαν
h)peirogene\s	adjective	ἠπειρογενής
kate/xousin	verb	κατέχω
e)/qnos	noun	ἔθνος
,	SENT	,
tou\s	article	ὁ
*mhtrogaqh\s	noun	Μητρογαθής
*)arkteu/s	noun	Ἀρκτεύς
t'	particle	τε
a)gaqo/s	adjective	ἀγαθός
,	SENT	,
basilh=s	noun	βασιλεύς
di/opoi	noun	δίοπος
,	SENT	,
kai\	conjunction	???/καί
polu/xrusoi	adjective	πολύχρυσος
*sa/rdeis	noun	Σάρδεις
e)po/xous	adjective	ἔποχος
polloi=s	adjective	πολύς
a(/rmasin	noun	ἅρμα
e)cormw=sin	verb	ἐξορμέω/ἐξορμάω
,	SENT	,
di/rruma/	adjective	δίρρυμος
te	particle	τε/??/οὔτε
kai\	conjunction	???/καί
tri/rruma	adjective	τρίρρυμος
te/lh	noun	τέλος
,	SENT	,
fobera\n	adjective	φοβερός
o)/yin	noun	ὄψις
proside/sqai	verb	προσεῖδον
.	SENT	.
steu=tai	verb	στεῦμαι
d'	particle	οὐδέ/δέ/??
i(erou=	noun	ἱερόν
*tmw/lou	noun	Τμῶλος
pela/tai	noun	πελάτης
zugo\n	noun	ζυγός/ζυγόν
a)mfibalei=n	verb	ἀμφιβάλλω
dou/lion	adjective	δούλιος
*(ella/di	noun	Ἑλλάς/ʽἑλλάς
,	SENT	,
*ma/rdwn	noun	Μάρδων/Μάρδος
,	SENT	,
*qa/rubis	noun	Θάρυβις
,	SENT	,
lo/gxhs	noun	λόγχη
a)/kmones	noun	ἄκμων
,	SENT	,
kai\	conjunction	???/καί
a)kontistai\	noun	ἀκοντιστής
*musoi/	noun	Μυσός
:	SENT	:
*babulw\n	noun	Βαβυλών
d'	particle	οὐδέ/δέ/??
h(	article	ὁ
polu/xrusos	adjective	πολύχρυσος
pa/mmikton	adjective	πάμμικτος/παμμιγής
o)/xlon	noun	ὄχλος
pe/mpei	verb	πέμπω
su/rdhn	adverb	σύρδην
,	SENT	,
naw=n	noun	ναῦς/ναός
t'	particle	τε
e)po/xous	adjective	ἔποχος
kai\	conjunction	???/καί
tocoulkw=|	adjective	τοξουλκός
lh/mati	noun	λῆμα
pistou/s	adjective	πιστός
:	SENT	:
to\	article	ὁ
maxairofo/ron	adjective	μαχαιροφόρος
t'	particle	τε
e)/qnos	noun	ἔθνος
e)k	preposition	ἐκ
pa/shs	pronoun	πᾶς
*)asi/as	noun	Ἀσίας/Ἀσία/̓Ασία
e(/petai	verb	ἕπομαι
deinai=s	adjective	δεινός
basile/ws	noun	βασιλεύς
u(po\	preposition	ὑπό
pompai=s	noun	πομπή
.	SENT	.
toio/nd'	pronoun	τοιόσδε
a)/nqos	noun	ἄνθος
*persi/dos	noun	Περσίς
ai)/as	noun	αἶα
oi)/xetai	verb	οἴχομαι
a)ndrw=n	noun	ἀνήρ
,	SENT	,
ou(\s	pronoun	ὁ/ὅς
pe/ri	preposition	περί
pa=sa	pronoun	πᾶς
xqw\n	noun	χθών
*)asih=tis	adjective	Ἀσιᾶτις
qre/yasa	verb	τρέφω
po/qw|	noun	πόθος
ste/netai	verb	στένω
malerw=|	adjective	μαλερός
,	SENT	,
toke/es	noun	τοκεύς
t'	particle	τε
a)/loxoi/	noun	ἄλοχος
q'	particle	τε
h(merolegdo\n	adverb	ἡμερολεγδόν
tei/nonta	verb	τείνω
xro/non	noun	χρόνος
trome/ontai	verb	τρομέω
.	SENT	.
pepe/raken	verb	περάω
me\n	adverb	μέν
o(	article	ὁ
perse/ptolis	noun	περσέπολις/περσέπτολις
h)/dh	adverb	ἠδή/ἤδη/ἦδη
basi/leios	adjective	βασίλειος
strato\s	noun	στρατός
ei)s	preposition	εἰς
a)n	unknown	unknown
-	SENT	-
ti/poron	adjective	ἀντίπορος
gei/tona	noun	γείτων
xw/ran	noun	χώρα
,	SENT	,
linode/smw|	adjective	λινόδεσμος
sxedi/a|	noun	σχεδία
porq	unknown	unknown
-	SENT	-
mo\n	unknown	unknown
a)mei/yas	verb	ἀμείβω
*)aqamanti/dos	adjective	Ἀθαμαντίς
*(/ellas	noun	Ἕλλη
,	SENT	,
polu/gomfon	adjective	πολύγομφος
o(/disma	noun	ὅδισμα
zugo\n	noun	ζυγός/ζυγόν
a)mfibalw\n	verb	ἀμφιβάλλω
au)xe/ni	noun	αὐχήν
po/ntou	noun	ποντός/πόντος
.	SENT	.
polua/ndrou	adjective	πολύανδρος
d'	particle	οὐδέ/δέ/??
*)asi/as	noun	Ἀσίας/Ἀσία/̓Ασία
qou/rios	adjective	θούριος
a)/rxwn	noun	ἄρχων
e)pi\	preposition	ἐπί
pa=san	pronoun	πᾶς
xqo/na	noun	χθών
poima	unknown	unknown
-	SENT	-
no/rion	noun	ποιμανόριον
qei=on	adjective	θεῖον/θεῖος
e)lau/nei	verb	ἐλαύνω
dixo/qen	adverb	διχόθεν
,	SENT	,
pezono/mon	adjective	πεζονόμος
t'	particle	τε
e)/k	preposition	ἐκ
te	particle	τε/??/οὔτε
qala/ssas	noun	θάλασσα
,	SENT	,
e)xuroi=si	adjective	ἐχυρός
pepoiqw\s	verb	πείθω
stufeloi=s	adjective	στυφελός
e)fe/tais	noun	ἐφέτης/ἐφέται
,	SENT	,
xru	unknown	unknown
-	SENT	-
sogo/nou	adjective	χρυσόγονος
genea=s	noun	γενεά
i)so/qeos	adjective	ἰσόθεος
fw/s	noun	φώς
.	SENT	.
kua/neon	adjective	κυάνεος
d'	particle	οὐδέ/δέ/??
o)/mmasi	noun	ὄμμα
leu/sswn	verb	λεύσσω
foni/ou	adjective	φόνιος
de/rgma	noun	δέργμα
dra/kontos	noun	δράκων
,	SENT	,
polu/xeir	noun	πολύχειρ
kai\	conjunction	???/καί
polunau/tas	noun	πολυναύτης
,	SENT	,
*su/rio/n	adjective	Σύριος
q'	particle	τε
a(/rma	noun	ἅρμα
diw/kwn	verb	διώκω
,	SENT	,
e)pa/gei	verb	ἐπάγω
douriklu/tois	noun	δουρικλυτός
a)n	unknown	unknown
-	SENT	-
dra/si	noun	ἀνήρ
toco/damnon	adjective	τοξόδαμνος
*)/arh	noun	Ἄρης/῎Αρης
.	SENT	.
do/kimos	adjective	δόκιμος
d'	particle	οὐδέ/δέ/??
ou)/tis	adjective	οὔτις
u(posta\s	verb	ὑφίστημι
mega/lw|	adjective	μέγας
r(eu/mati	noun	ῥεῦμα
fwtw=n	noun	φώς
e)xuroi=s	adjective	ἐχυρός
e(/rkesin	noun	ἕρκος
ei)/rgein	verb	ἔργω
a)/maxon	adjective	ἄμαχος
ku=ma	noun	κῦμα
qala/ssas	noun	θάλασσα
:	SENT	:
a)pro/soistos	adjective	ἀπρόσοιστος
ga\r	adverb	γάρ
o(	article	ὁ
*persa=n	noun	Πέρσης/πέρσης
strato\s	noun	στρατός
a)lki/frwn	adjective	ἀλκίφρων
te	particle	τε/??/οὔτε
lao/s	noun	λαός
.	SENT	.
qeo/qen	adverb	θεόθεν
ga\r	particle	γάρ
kata\	preposition	κατά
*moi=r'	noun	μοῖρα
e)kra/thsen	verb	κρατέω
to\	article	ὁ
palai	noun	πάλα
-	SENT	-
o/n	adjective	παλαιός
,	SENT	,
e)pe/skhye	verb	ἐπισκήπτω
de\	particle	μηδέ/δέ/οὐδέ
*pe/rsais	noun	Πέρσης/πέρσης
pole/mous	noun	πολέμος/πολεμός/πόλεμος
purgodai/+ktous	adjective	πυργοδάικτος
die/pein	verb	διέπω
i(ppioxa/rmas	noun	ἱππιοχάρμης
te	particle	τε/??/οὔτε
klo/nous	noun	κλόνος
po/lew/n	noun	πόλις
t'	particle	τε
a)nasta/seis	noun	ἀνάστασις
.	SENT	.
e)/maqon	verb	μανθάνω
d'	particle	οὐδέ/δέ/??
eu)rupo/roi-	unknown	unknown
o	adjective	εὐρύπορος
qala/ssas	noun	θάλασσα
poliai-	unknown	unknown
nome/nas	verb	πολιαίνομαι
pneu/mati	noun	πνεῦμα
la/brw|	adjective	λάβρος
e)sora=n	verb	εἰσοράω
po/ntion	adjective	πόντιος
a)/lsos	noun	ἄλσος
,	SENT	,
pi/sunoi	adjective	πίσυνος
leptodo/mois	adjective	λεπτόδομος
pei/-	unknown	unknown
smasi	noun	πεῖσμα
la-	unknown	unknown
opo/rois	adjective	λαοπόρος
te	particle	τε/??/οὔτε
maxanai=s	noun	μηχανή
.	SENT	.
dolo/mhtin	noun	δολομήτης
d'	particle	οὐδέ/δέ/??
a)pa/tan	noun	ἀπάτη
qeou=	noun	θέος/θεός
ti/s	pronoun	τις/τίς/τὶς
a)nh\r	noun	ἀνήρ
qnato\s	adjective	θνητός
a)lu/cei	noun	ἄλυξις
;	SENT	;
ti/s	pronoun	τις/τίς/τὶς
o(	article	ὁ
kraipnw=|	adjective	κραιπνός
podi\	noun	πούς
ph/dh-	unknown	unknown
ma	noun	πήδημα
to/d'	pronoun	ὅδε
eu)petw=s	adverb	εὐπετής
a)na/|sswn	verb	ἀνᾴσσω/ἀναίσσω
;	SENT	;
filo/frwn	adjective	φιλόφρων
ga\r	particle	γάρ
parasai/nei	verb	παρασαίνω
broto\n	noun	βροτός
ei)s	preposition	εἰς
a)/rkuas	noun	ἄρκυς
*)/ata	adjective	ἆτος
,	SENT	,
to/qen	adverb	τόθεν
ou)k	adverb	οὐ
e)/stin	verb	εἰμί#1/εἰμί
u(/perqe/n	preposition	ὕπερθεν
nin	pronoun	νιν
a)/naton	adjective	ἄνατος
e)calu/cai	verb	ἐξαλύσκω
.	SENT	.
tau=ta/	pronoun	οὗτος
moi	pronoun	τις/ἐγώ
melagxi/twn	noun	μελαγχίτων
frh\n	noun	φρήν
a)mu/ssetai	verb	ἀμύσσω
fo/bw|	noun	φόβος
,	SENT	,
o)a=	interjection	ὀᾶ
,	SENT	,
*persikou=	adjective	Περσικός/περσικός
strateu/matos	noun	στράτευμα
tou=de	adjective	ὅδε
,	SENT	,
mh\	adverb	μή/μὴ
po/lis	noun	πόλις/πόόλις
pu/qh-	unknown	unknown
tai	verb	πυνθάνομαι/κελαινόομαι/φοβέω/ἐλευθερόω/αὐδάω
ke/nandron	adjective	κένανδρος
me/g'	adjective	μέγας
a)/stu	noun	ἄστυ
*sousi/dos	noun	Σουσίς
,	SENT	,
kai\	conjunction	???/καί
to\	article	ὁ
*kissi/wn	noun	Κίσσιοι
po/lism'	noun	πόλισμα
a)nti/doupon	adjective	ἀντίδουπος
a)/|setai	verb	ἀείδω
,	SENT	,
o)a=	interjection	ὀᾶ
,	SENT	,
tou=t'	adjective	οὗτος
e)/pos	noun	ἔπος
gunaikoplh	unknown	unknown
-	SENT	-
qh\s	adjective	θυμοπληθής/γυναικοπληθής
o(/milos	noun	ὅμιλος
a)pu/wn	adjective	ἄπυος
,	SENT	,
bussi/nois	adjective	βύσσινος
d'	particle	οὐδέ/δέ/??
e)n	preposition	ἐν/εἰς
pe/plois	noun	πεπλος/πέπλος
pe/sh|	verb	πίπτω
laki/s	noun	λακίς
.	SENT	.
pa=s	pronoun	πᾶς
ga\r	particle	γάρ
i(pphla/tas	noun	ἱππηλάτης
kai\	conjunction	???/καί
pedostibh\s	adjective	πεδοστιβής
lew\s	noun	λαός
smh=nos	noun	σμῆνος
w(\s	adverb	ὥς/ὡς
e)kle/loipen	verb	ἐκλείπω
melis	unknown	unknown
-	SENT	-
sa=n	noun	μέλισσα
su\n	preposition	σύν
o)rxa/mw|	noun	ὄρχαμος
stratou=	noun	στρατός
,	SENT	,
to\n	article	ὁ/τὸν
a)mfi/zeukton	adjective	ἀμφίζευκτος
e)camei/yas	verb	ἐξαμείβω
a)mfote/ras	pronoun	ἀμφότερος
a(/lion	adjective	ἅλιος
prw=na	noun	πρών
koino\n	adjective	κοινός
ai)/as	noun	αἶα
.	SENT	.
le/ktra	noun	λέκτρον
d'	particle	οὐδέ/δέ/??
a)ndrw=n	noun	ἀνήρ
po/qw|	noun	πόθος
pi/mplatai	verb	πίμπλημι
dakru/masin	noun	δάκρυμα
:	SENT	:
*persi/des	noun	περσίς/Περσίς
d'	particle	οὐδέ/δέ/??
a(bropenqei=s	adjective	ἁβροπενθής
e(ka/	unknown	unknown
-	SENT	-
sta	adjective	ἕκαστος
po/qw|	noun	πόθος
fila/nori	noun	φιλάνωρ
to\n	article	ὁ/τὸν
ai)xma/enta	adjective	αἰχμήεις
qou=ron	adjective	θοῦρος
eu)na	unknown	unknown
-	SENT	-
th=r'	noun	εὐνατήρ
a)popemyame/na	verb	ἀποπέμπω
lei/petai	verb	λείπω
mono/zuc	noun	μονόζυξ
.	SENT	.
a)ll'	conjunction	/ἀλλά/ἀλλα/ἀλλ̓
a)/ge	adverb	ἄγε
,	SENT	,
*pe/rsai	noun	Πέρσης/πέρσης
,	SENT	,
to/d'	pronoun	ὅδε
e)nezo/menoi	verb	ἐνέζομαι
ste/gos	noun	στέγος
a)rxai=on	adjective	ἀρχαῖος
,	SENT	,
fronti/da	noun	φροντίς
kednh\n	adjective	κεδνός
kai\	conjunction	???/καί
baqu/boulon	adjective	βαθύβουλος
qw/meqa	verb	θέω/τίθημι/θάομαι/θάζω
,	SENT	,
xrei/a	noun	χρέος/χρεία
de\	particle	μηδέ/δέ/οὐδέ
prosh/kei	verb	προσήκω
,	SENT	,
pw=s	adverb	πως/πῶς
a)/ra	particle	ἄρα
pra/ssei	verb	πράσσω
*ce/rchs	proper	Ξέρξης
basileu\s	noun	βασιλεύς
*dareiogenh/s	adjective	Δαρειογενής
,	SENT	,
to\	article	ὁ
patrwnu/mion	adjective	πατρωνύμιος
ge/nos	noun	γένος
h(me/teron	adjective	ἡμέτερος
:	SENT	:
po/teron	adjective	πότερος
to/cou	noun	τόξον
r(u=ma	noun	ῥῦμα
to\	article	ὁ
nikw=n	verb	νικάω
,	SENT	,
h)\	conjunction	ἤ
dorikra/nou	adjective	δορίκρανος
lo/gxhs	noun	λόγχη
i)sxu\s	noun	ἰσχύς
kekra/thken	verb	κρατέω
.	SENT	.
a)ll'	conjunction	/ἀλλά/ἀλλα/ἀλλ̓
h(/de	pronoun	ὅδε
qew=n	noun	θέος/θεεός/θέα/θεά/θεός/θεὸς
i)/son	adjective	ἴσος
o)fqalmoi=s	noun	ὀφθαλμός
fa/os	noun	φάος
o(rma=tai	verb	ὁρμάζω/ὁρμάω
mh/thr	noun	μήτηρ
basile/ws	noun	βασιλεύς
,	SENT	,
basi/leia	noun	βασίλεια#1/βασίλεια/βασίλειον
d'	particle	οὐδέ/δέ/??
e)mh/	adjective	ἐμός
:	SENT	:
prospi/tnw	verb	προσπίτνω/προσπίπτω
:	SENT	:
kai\	conjunction	???/καί
prosfqo/ggois	adjective	πρόσφθογγος
de\	adverb	δέ/οὐ
xrew\n	unknown	χρεών
au)th\n	pronoun	αὐτός
pa/ntas	adjective	/πᾶς
mu/qoisi	noun	μῦθος
prosauda=n	verb	προσαυδάω
.	SENT	.
w)=	interjection	ὦ
baquzw/nwn	adjective	βαθύζωνος
a)/nassa	noun	ἄνασσα
*persi/dwn	noun	Περσίς
u(perta/th	adjective	ὑπέρ/ὑπέρτατος
,	SENT	,
mh=ter	noun	μήτηρ
h(	article	ὁ
*ce/rcou	noun	Ξέρξης/ξέρξης
geraia/	adjective	γεραιός
,	SENT	,
xai=re	verb	χαίρω
,	SENT	,
*darei/ou	noun	Δαρεῖος
gu/nai	noun	γυνή
:	SENT	:
qeou=	noun	θέος/θεός
me\n	particle	μέν
eu)na/teira	noun	εὐνητήρ
*persw=n	noun	Πέρσης/Ρέρσης/πέρσης
,	SENT	,
qeou=	noun	θέος/θεός
de\	particle	μηδέ/δέ/οὐδέ
kai\	conjunction	???/καί
mh/thr	noun	μήτηρ
e)/fus	verb	φύω
,	SENT	,
ei)/	conjunction	εἰ
ti	pronoun	τις/τίς/τὶς
mh\	adverb	μή/μὴ
dai/mwn	noun	δαίμων
palaio\s	adjective	παλαιός
nu=n	adverb	νῦν#1/νῦν
meqe/sthke	verb	μεθίστημι
stratw=|	noun	στρατός
.	SENT	.
tau=ta	pronoun	οὗτος
dh\	particle	δή
lipou=s'	verb	λιπάω/λίπτομαι/λείπω
i(ka/nw	verb	ἱκανόω/ἱκάνω
xruseosto/lmous	adjective	χρυσεόστολμος
do/mous	noun	δόμος
kai\	conjunction	???/καί
to\	article	ὁ
*darei/ou	proper	Δαρεῖος
te	particle	τε/??/οὔτε
ka)mo\n	adjective	ἐμός
koino\n	adjective	κοινός
eu)nath/rion	noun	εὐνατήριον
.	SENT	.
ka)me\	pronoun	ἐγώ
kardi/an	noun	καρδία
a)mu/ssei	verb	ἀμύσσω
fronti/s	noun	φροντίς
:	SENT	:
e)s	preposition	εἰς
d'	particle	οὐδέ/δέ/??
u(ma=s	pronoun	σύ/ὑμεῖς
e)rw=	verb	λέγω/ἐρῶ/ἐρέω/ἐράομαι/ἐράω
mu=qon	noun	μῦθος
ou)damw=s	adverb	οὐδαμῶς/οὐδαμός
e)mauth=s	pronoun	ἐμαυτοῦ
ou)=s'	verb	εἰμί
a)dei/mantos	adjective	ἀδείμαντος
,	SENT	,
fi/loi	adjective	φίλος
,	SENT	,
mh\	adverb	μή/μὴ
me/gas	adjective	μέγας
plou=tos	noun	πλοῦτος
koni/sas	verb	κονίω/κονίζω
ou)=das	noun	οὖδας
a)ntre/yh|	verb	ἀνατρέπω
podi\	noun	πούς
o)/lbon	noun	ὄλβος
,	SENT	,
o(\n	pronoun	ὁ/ὅς
*darei=os	noun	Δαρεῖος/δαρεῖος
h)=ren	verb	αἴρω/ἀείρω
ou)k	adverb	οὐ
a)/neu	preposition	ἄνευ
qew=n	noun	θέος/θεεός/θέα/θεά/θεός/θεὸς
tinos	adjective	τις
.	SENT	.
tau=ta/	pronoun	οὗτος
moi	pronoun	τις/ἐγώ
diplh=	adjective	διπλόος
me/rimna	noun	μέριμνα
frasto/s	adjective	φραστός/ἄφραστος
e)stin	verb	εἰμί#1/εἰμί
e)n	preposition	ἐν/εἰς
fresi/n	noun	φρήν
,	SENT	,
mh/te	conjunction	μήτε
xrhma/twn	noun	χρῆμα
a)na/ndrwn	adjective	ἄνανδρος
plh=qos	noun	πλῆθος
e)n	preposition	ἐν/εἰς
timh=|	noun	τιμή
se/bein	verb	σέβω
mh/t'	particle	μήτε
a)xrhma/toisi	adjective	ἀχρήματος
la/mpein	verb	λάμπω
fw=s	noun	φάος/φῶς
o(/son	adjective	ὅσος
sqe/nos	noun	σθένος
pa/ra	verb	πάρειμι/πάρα
.	SENT	.
e)/sti	verb	εἰμί#1/εἰμί
ga\r	particle	γάρ
plou=to/s	noun	πλοῦτος
g'	particle	γε
a)memfh/s	adjective	ἀμεμφής/ἄμεμπτος
,	SENT	,
a)mfi\	preposition	ἀμφί
d'	particle	οὐδέ/δέ/??
o)fqalmw=|	noun	ὀφθαλμός
fo/bos	noun	φόβος
:	SENT	:
o)/mma	noun	ὄμμα
ga\r	particle	γάρ
do/mwn	noun	δόμος
nomi/zw	verb	νομίζω
despo/tou	noun	δεσπότης
parousi/an	noun	παρουσία
.	SENT	.
pro\s	preposition	πρός
ta/d'	pronoun	ὅδε
w(s	adverb	ὡς#2/ʽὡς/ὥς/ὡς
ou(/tws	adverb	οὕτω(ς)/οὕτως
e)xo/ntwn	verb	ἔχω
tw=nde	pronoun	ὅδε
,	SENT	,
su/mbouloi	noun	σύμβουλος
lo/gou	noun	λόγος
tou=de/	pronoun	ὅδε
moi	pronoun	τις/ἐγώ
ge/nesqe	verb	γίγνομαι
,	SENT	,
*pe/rsai	noun	Πέρσης/πέρσης
,	SENT	,
ghrale/a	adjective	γηραλέος/γηραιός
pistw/mata	noun	πίστωμα
:	SENT	:
pa/nta	pronoun	πᾶς
ga\r	adverb	γάρ
ta\	article	ὁ/τίς
ke/dn'	adjective	κέδνος/κεδνός
e)n	preposition	ἐν/εἰς
u(mi=n	pronoun	σύ/ὑμεῖς
e)sti/	verb	εἰμί#1/εἰμί
moi	pronoun	τις/ἐγώ
bouleu/mata	noun	βούλευμα
.	SENT	.
eu)=	adverb	εὖ
to/d'	pronoun	ὅδε
i)/sqi	verb	εἰμί#1/εἰμί/οἶδα
,	SENT	,
gh=s	noun	Γαῖα/γῆ
a)/nassa	noun	ἄνασσα
th=sde	adjective	ὅδε
,	SENT	,
mh/	conjunction	μή
se	pronoun	σύ
di\s	adverb	δίς
fra/sai	verb	φράζω
mh/t'	adjective	μήτις
e)/pos	noun	ἔπος
mh/t'	particle	μήτε
e)/rgon	noun	ἔργον
w(=n	pronoun	ὅς
a)\n	adverb	ἀν/ἄν/ἐάν
du/namis	noun	δύναμις
h(gei=sqai	verb	ἡγέομαι
qe/lh|	verb	ἐθέλω
:	SENT	:
eu)menei=s	adjective	εὐμενής
ga\r	particle	γάρ
o)/ntas	verb	εἰμί#1/εἰμί
h(ma=s	pronoun	ἐγώ/ἡμεῖς
tw=nde	pronoun	ὅδε
sumbou/lous	noun	σύμβουλος
kalei=s	verb	καλέω
.	SENT	.
polloi=s	adjective	πολύς
me\n	particle	μέν
ai)ei\	adverb	ἀεί
nukte/rois	adjective	νύκτερος
o)nei/rasin	noun	ὄνειρος
cu/neim'	verb	σύνειμι
,	SENT	,
a)f'	preposition	ἐπί/ἀπό
ou(=per	adverb	οὗπερ
pai=s	noun	παῖς
e)mo\s	adjective	ἐμός
stei/las	verb	στέλλω
strato\n	noun	στρατός
*)iao/nwn	noun	̓ἰάων/Ἰάονες
gh=n	noun	Γαῖα/γῆ
oi)/xetai	verb	οἴχομαι
pe/rsai	verb	πέρθω
qe/lwn	verb	ἐθέλω
:	SENT	:
a)ll'	conjunction	/ἀλλά/ἀλλα/ἀλλ̓
ou)/ti	adverb	οὔτι
pw	particle	πω
toio/nd'	pronoun	τοιόσδε
e)narge\s	adjective	ἐναργής
ei)do/mhn	verb	εἴδομαι/εἶδον
w(s	conjunction	ὥς/ὡς
th=s	article	ὁ
pa/roiqen	adverb	πάροιθεϝ/πάροιθε
eu)fro/nhs	noun	εὐφρόνη
:	SENT	:
le/cw	verb	λέγω
de/	particle	δέ/οὐδέ
soi	pronoun	σοι/σύ
.	SENT	.
e)doca/thn	verb	δοκέω
moi	pronoun	τις/ἐγώ
du/o	adjective	δύο
gunai=k'	noun	γυνή
eu)ei/mone	adjective	εὐείμων
,	SENT	,
h(	article	ὁ
me\n	adverb	μέν
pe/ploisi	noun	πεπλος/πέπλος
*persikoi=s	adjective	Περσικός
h)skhme/nh	verb	ἀσκέω
,	SENT	,
h(	article	ὁ
d'	particle	οὐδέ/δέ/??
au)=te	adverb	αὖτε
*dwrikoi=sin	adjective	Δωρικός
,	SENT	,
ei)s	preposition	εἰς
o)/yin	noun	ὄψις
molei=n	verb	βλώσκω
,	SENT	,
mege/qei	noun	μέγεθος
te	particle	τε/??/οὔτε
tw=n	pronoun	ὁ//ὅς
nu=n	adverb	νῦν#1/νῦν
e)kprepesta/ta	adjective	ἐκπρεπής
polu/	adjective	πολύς
,	SENT	,
ka/llei	noun	κάλλος
t'	particle	τε
a)mw/mw	noun	ἄμωμον
,	SENT	,
kai\	conjunction	???/καί
kasignh/ta	noun	κασιγνήτη
ge/nous	noun	γένος
tau)tou=	adjective	αὐτός/ταὐτός/ταυτός
:	SENT	:
pa/tran	noun	πάτρη/φράτρα/πάτρα
d'	particle	οὐδέ/δέ/??
e)/naion	verb	ναίω
h(	article	ὁ
me\n	adverb	μέν
*(ella/da	proper	Ἑλλάς
klh/rw|	noun	κλῆρος
laxou=sa	verb	λαγχάνω
gai=an	noun	γαῖα
,	SENT	,
h(	article	ὁ
de\	adverb	δέ/οὐ
ba/rbaron	adjective	βάρβαρος
.	SENT	.
tou/tw	adjective	οὗτος
sta/sin	noun	στάσις
tin'	pronoun	τις
,	SENT	,
w(s	conjunction	ὥς/ὡς
e)gw\	pronoun	ἐγώ
'	unknown	unknown
do/koun	verb	δοκἐω/δοκέω
o(ra=n	verb	ὁράω
,	SENT	,
teu/xein	verb	τεύχω
e)n	preposition	ἐν/εἰς
a)llh/laisi	adjective	ἀλλήλων
:	SENT	:
pai=s	noun	παῖς
d'	particle	οὐδέ/δέ/??
e)mo\s	adjective	ἐμός
maqw\n	verb	μανθάνω
katei=xe	verb	κατέχω
ka)pra/unen	verb	πραύνω
,	SENT	,
a(/rmasin	noun	ἅρμα
d'	particle	οὐδέ/δέ/??
u(/po	preposition	ὑπό
zeu/gnusin	verb	ζεύγνυμι
au)tw\	adjective	αὐτός
kai\	conjunction	???/καί
le/padn'	noun	λέπαδνον
e)p'	preposition	ἐπί/ἐπι
au)xe/nwn	noun	αὐχήν
ti/qhsi	verb	τίθημι
.	SENT	.
xh)	article	ὁ
me\n	adverb	μέν
th=|d'	pronoun	ὅδε
e)purgou=to	verb	πυργόω
stolh=|	noun	στολή
e)n	preposition	ἐν/εἰς
h(ni/aisi/	noun	ἡνία
t'	particle	τε
ei)=xen	verb	ἔχω
eu)/arkton	adjective	εὔαρκτος
sto/ma	noun	στόμα
,	SENT	,
h(	article	ὁ
d'	particle	οὐδέ/δέ/??
e)sfa/daze	verb	σφαδάζω
,	SENT	,
kai\	conjunction	???/καί
xeroi=n	noun	χείρ
e)/nth	noun	ἔντεα
di/frou	noun	δίφρος
diaspara/ssei	verb	διασπαράσσω
kai\	conjunction	???/καί
cunarpa/zei	verb	συναρπάζω
bi/a|	noun	βία
a)/neu	preposition	ἄνευ
xalinw=n	noun	χαλινός
kai\	conjunction	???/καί
zugo\n	noun	ζυγός/ζυγόν
qrau/ei	verb	θραύω
me/son	adjective	μέσος
.	SENT	.
pi/ptei	verb	πίπτω
d'	particle	οὐδέ/δέ/??
e)mo\s	adjective	ἐμός
pai=s	noun	παῖς
,	SENT	,
kai\	conjunction	???/καί
path\r	noun	πατήρ
pari/statai	verb	παρίστημι
*darei=os	proper	Δαρεῖος
oi)ktei/rwn	verb	οἰκτείρω
sfe	pronoun	σφεῖς
:	SENT	:
to\n	article	ὁ/τὸν
d'	particle	οὐδέ/δέ/??
o(/pws	conjunction	ὅπως
o(ra=|	verb	ὁράω
*ce/rchs	noun	Ξέρξης/Ξήρξης
,	SENT	,
pe/plous	noun	πεπλος/πέπλος
r(h/gnusin	verb	ῥήγνυμι
a)mfi\	preposition	ἀμφί
sw/mati	noun	σῶμα
.	SENT	.
kai\	conjunction	???/καί
tau=ta	pronoun	οὗτος
me\n	adverb	μέν
dh\	adverb	δή
nukto\s	noun	νύξ
ei)sidei=n	verb	εἰσεῖδον/εἶδον/εἰσοράω/εἰσιδέω
le/gw	verb	λέγω
.	SENT	.
e)pei\	conjunction	ἐπεί
d'	particle	οὐδέ/δέ/??
a)ne/sthn	verb	ἀνίστημι
kai\	conjunction	???/καί
xeroi=n	noun	χείρ
kallirro/ou	adjective	καλλίρροος/καλλίρρους
e)/yausa	verb	ψαύω
phgh=s	noun	πηγή
,	SENT	,
su\n	preposition	σύν
quhpo/lw|	adjective	θυηπόλος
xeri\	noun	χείρ
bwmo\n	noun	βωμός
prose/sthn	verb	προσίστημι
,	SENT	,
a)potro/poisi	adjective	ἀπότροπος
dai/mosin	noun	δαίμων
qe/lousa	verb	ἐθέλω
qu=sai	verb	θύω
pe/lanon	noun	πέλανος
,	SENT	,
w(=n	pronoun	ὅς
te/lh	noun	τέλος
ta/de	pronoun	ὅδε
.	SENT	.
o(rw=	verb	ὁράω
de\	particle	μηδέ/δέ/οὐδέ
feu/gont'	verb	φεύγω
ai)eto\n	noun	ἀετός
pro\s	preposition	πρός
e)sxa/ran	noun	ἐσχάρα
*foi/bou	noun	Φοῖβος
:	SENT	:
fo/bw|	noun	φόβος
d'	particle	οὐδέ/δέ/??
a)/fqoggos	adjective	ἄφθογγος
e)sta/qhn	verb	ἵστημι
,	SENT	,
fi/loi	adjective	φίλος
:	SENT	:
mequ/steron	adjective	μεθύστερος
de\	particle	μηδέ/δέ/οὐδέ
ki/rkon	noun	κίρκος
ei)sorw=	verb	εἰσοράω
dro/mw|	noun	δρόμος
pteroi=s	noun	πτερόν
e)formai/nonta	verb	ἐφορμαίνω
kai\	conjunction	???/καί
xhlai=s	noun	χηλή
ka/ra	noun	κάρα/κάρον
ti/llonq'	verb	τίλλω
:	SENT	:
o(	article	ὁ
d'	particle	οὐδέ/δέ/??
ou)de\n	pronoun	οὐδείς
a)/llo	adjective	ἄλλος
g'	particle	γε
h)\	conjunction	ἤ
pth/cas	verb	πτήσσω
de/mas	noun	δέμας
parei=xe	verb	παρέχω
.	SENT	.
tau=t'	adjective	οὗτος
e)/moige	pronoun	ἐγώ
dei/mat'	noun	δεῖμα
ei)sidei=n	verb	εἰσεῖδον/εἶδον/εἰσοράω/εἰσιδέω
,	SENT	,
u(mi=n	pronoun	σύ/ὑμεῖς
d'	particle	οὐδέ/δέ/??
a)kou/ein	verb	ἀκούω
.	SENT	.
eu)=	adverb	εὖ
ga\r	particle	γάρ
i)/ste	verb	οἶδα
,	SENT	,
pai=s	noun	παῖς
e)mo\s	pronoun	ἐμός
pra/cas	verb	πράσσω
me\n	adverb	μέν
eu)=	adverb	εὖ
qaumasto\s	adjective	θαυμαστός
a)\n	adverb	ἀν/ἄν/ἐάν
ge/noit'	verb	γίγνομαι
a)nh/r	noun	ἀνήρ
,	SENT	,
kakw=s	adverb	κακῶς/κακός
de\	particle	μηδέ/δέ/οὐδέ
pra/cas	verb	πράσσω
,	SENT	,
ou)x	adverb	οὐ
u(peu/qunos	adjective	ὑπεύθυνος
po/lei	noun	πόλις
,	SENT	,
swqei\s	verb	σώζω
d'	particle	οὐδέ/δέ/??
o(moi/ws	adverb	ὁμοιός/ὁμοίως/ὁμοῖος/ὅμοιος
th=sde	pronoun	ὅδε
koiranei=	verb	κοιρανέω
xqono/s	noun	χθών
.	SENT	.
ou)/	adverb	οὔπως/οὔτι/οὔτε/οὐ
se	pronoun	σύ
boulo/mesqa	verb	βούλομαι
,	SENT	,
mh=ter	noun	μήτηρ
,	SENT	,
ou)/	adverb	οὔπως/οὔτι/οὔτε/οὐ
t'	particle	τε
a)/gan	adverb	ἄγαν
fobei=n	verb	φοβέω
lo/gois	noun	λόγος
ou)/	adverb	οὔπως/οὔτι/οὔτε/οὐ
te	adverb	τε/οὔτε
qarsu/nein	verb	θαρσύνω
.	SENT	.
qeou\s	noun	θεός
de\	particle	μηδέ/δέ/οὐδέ
prostropai=s	noun	προστροπή
i(knoume/nh	verb	ἱκνέομαι
,	SENT	,
ei)/	conjunction	εἰ
ti	pronoun	τις/τίς/τὶς
flau=ron	adjective	φλαῦρος
ei)=des	verb	εἶδον/ὁράω
,	SENT	,
ai)tou=	verb	αἰτέω
tw=nd'	pronoun	ὅδε
a)potroph\n	noun	ἀποτροπή
telei=n	verb	τελέω/τέλλω
,	SENT	,
ta\	article	ὁ/τίς
d'	particle	οὐδέ/δέ/??
a)ga/q'	adjective	ἀγατός/ἀγαστός
e)ktelh=	adjective	ἐκτελής
gene/sqai	verb	γίγνομαι
soi/	pronoun	σύ
te	adverb	τε/οὔτε
kai\	conjunction	???/καί
te/knois	noun	τέκνον
se/qen	pronoun	σύ
kai\	conjunction	???/καί
po/lei	noun	πόλις
fi/lois	adjective	φίλος
te	particle	τε/??/οὔτε
pa=si	adjective	πα~ς/πᾶς
.	SENT	.
deu/teron	adjective	δεύτερος
de\	particle	μηδέ/δέ/οὐδέ
xrh\	verb	χρή/χρὴ
xoa\s	noun	χοή
*gh=|	noun	γῆ
te	conjunction	τε/ὅτε
kai\	conjunction	???/καί
fqitoi=s	adjective	φθιτός
xe/asqai	verb	χέω
:	SENT	:
preumenw=s	adverb	πρευμενής
d'	particle	οὐδέ/δέ/??
ai)tou=	verb	αἰτέω
ta/de	pronoun	ὅδε
,	SENT	,
so\n	adjective	σός
po/sin	noun	πόσις/πούς
*darei=on	noun	Δαρεῖος/δαρεῖος
,	SENT	,
o(/nper	pronoun	ὅς
fh\s	verb	φημί
i)dei=n	verb	ἰδέω/εἶδον/ὁράω
kat'	preposition	κατα/κατά
eu)fro/nhn	noun	εὐφρόνη
,	SENT	,
e)sqla/	adjective	ἐσθλός
soi	pronoun	σοι/σύ
pe/mpein	verb	πέμπω
te/knw|	noun	τέκνον
te	particle	τε/??/οὔτε
gh=s	noun	Γαῖα/γῆ
e)/nerqen	adverb	ἔνερθε
e)s	preposition	εἰς
fa/os	noun	φάος
,	SENT	,
ta)/mpalin	adverb	ἔμπαλιν
de\	particle	μηδέ/δέ/οὐδέ
tw=nde	pronoun	ὅδε
gai/a|	noun	γαῖα
ka/toxa	adjective	κάτοχος
maurou=sqai	verb	μαυρόω
sko/tw|	noun	σκότος
.	SENT	.
tau=ta	pronoun	οὗτος
qumo/mantis	noun	θυμόμαντις
w)/n	verb	εἰμί#1/εἰμί
soi	pronoun	σοι/σύ
preumenw=s	adverb	πρευμενής
parh/|nesa	verb	παραινέω
.	SENT	.
eu)=	adverb	εὖ
de\	particle	μηδέ/δέ/οὐδέ
pantaxh=|	adverb	πανταχῇ/πανταχῆ
telei=n	verb	τελέω/τέλλω
soi	pronoun	σοι/σύ
tw=nde	pronoun	ὅδε
kri/nomen	verb	κρίνω
pe/ri	preposition	περί
.	SENT	.
a)lla\	conjunction	ἀλλά/ἀλλὰ
mh\n	particle	μήν
eu)/nous	adjective	εὔνους
g'	particle	γε
o(	article	ὁ
prw=tos	adjective	πρότερος/πρῶτος
tw=nd'	pronoun	ὅδε
e)nupni/wn	adjective	ἐνύπνιος
krith\s	noun	κριτής
paidi\	noun	παῖς
kai\	conjunction	???/καί
do/mois	noun	δόμος
e)moi=si	adjective	ἐμός
th/nd'	pronoun	ὅδε
e)ku/rwsas	verb	κυρόω
fa/tin	noun	φάτις
.	SENT	.
e)kteloi=to	verb	ἐκτελέω
dh\	adverb	δή
ta\	article	ὁ/τίς
xrhsta/	adjective	χρηστός
:	SENT	:
tau=ta	pronoun	οὗτος
d'	particle	οὐδέ/δέ/??
,	SENT	,
w(s	conjunction	ὥς/ὡς
e)fi/esai	verb	ἐφίημι
,	SENT	,
pa/nta	pronoun	πᾶς
qh/somen	verb	τίθημι
qeoi=si	noun	θέος/θεός
toi=s	article	ὁ
t'	particle	τε
e)/nerqe	preposition	ἔνερθε
gh=s	noun	Γαῖα/γῆ
fi/lois	adjective	φίλος
,	SENT	,
eu)=t'	conjunction	εὖτε
a)\n	particle	ἄν
ei)s	preposition	εἰς
oi)/kous	noun	οἶκος
mo/lwmen	verb	βλώσκω
.	SENT	.
kei=na	pronoun	ἐκεῖνος/κεῖνος
d'	particle	οὐδέ/δέ/??
e)kmaqei=n	verb	ἐκμανθάνω
qe/lw	verb	ἐθέλω
,	SENT	,
w)=	interjection	ὦ
fi/loi	adjective	φίλος
,	SENT	,
pou=	adverb	ποῦ/πού
ta\s	article	ὁ
*)aqh/nas	proper	Ἀθῆναι/Ἀθήνευς/Ἀθήνη
fasi\n	verb	φημί
i(dru=sqai	verb	ἱδρύω
xqono/s	noun	χθών
.	SENT	.
th=le	adverb	τῆλε
pro\s	preposition	πρός
dusmai=s	noun	δυσμή
a)/naktos	noun	ἄναξ
*(hli/ou	noun	ἥλιος/Ἥλιος
fqinasma/twn	noun	φθίνασμα
.	SENT	.
a)lla\	conjunction	ἀλλά/ἀλλὰ
mh\n	particle	μήν
i(/meir'	verb	ἱμείρω
e)mo\s	adjective	ἐμός
pai=s	noun	παῖς
th/nde	pronoun	ὅδε
qhra=sai	verb	θηράω
po/lin	noun	πόλις
;	SENT	;
pa=sa	pronoun	πᾶς
ga\r	particle	γάρ
ge/noit'	verb	γίγνομαι
a)\n	adverb	ἀν/ἄν/ἐάν
*(ella\s	noun	Ἑλλάς
basile/ws	noun	βασιλεύς
u(ph/koos	adjective	ὑπήκους/ὑπήκοος
.	SENT	.
w(=de/	adverb	ὧδε
tis	pronoun	τις/τίς/τὶς
pa/restin	verb	πάρειμι/πάρειμι#1
au)toi=s	pronoun	αὐτός
a)ndroplh/qeia	noun	ἀνδροπλήθεια
stratou=	noun	στρατός
;	SENT	;
kai\	conjunction	???/καί
strato\s	noun	στρατός
toiou=tos	adjective	τοιοῦτος
,	SENT	,
e)/rcas	verb	ἔρδω/ἔργω
polla\	adjective	πολύς
dh\	adverb	δή
*mh/dous	noun	Μῆδος
kaka/	adjective	κακός
.	SENT	.
kai\	conjunction	???/καί
ti/	pronoun	τις/τίς/τὶς
pro\s	preposition	πρός
tou/toisin	adjective	οὗτος
a)/llo	adjective	ἄλλος
;	SENT	;
plou=tos	noun	πλοῦτος
e)carkh\s	adjective	ἐξαρκής
do/mois	noun	δόμος
;	SENT	;
a)rgu/rou	noun	ἄργυρος
phgh/	noun	πηγή
tis	pronoun	τις/τίς/τὶς
au)toi=s	pronoun	αὐτός
e)sti	verb	εἰμί#1/εἰμί
,	SENT	,
qhsauro\s	noun	θησαυρός
xqono/s	noun	χθών
.	SENT	.
po/tera	adjective	πότερος
ga\r	particle	γάρ
tocoulko\s	adjective	τοξουλκός
ai)xmh\	noun	αἰχμή
dia\	preposition	διά
xeroi=n	noun	χείρ
au)toi=s	pronoun	αὐτός
pre/pei	verb	πρέπω
;	SENT	;
ou)damw=s	adverb	οὐδαμῶς/οὐδαμός
:	SENT	:
e)/gxh	noun	ἔγχος
stadai=a	adjective	σταδαῖος
kai\	conjunction	???/καί
fera/spides	noun	φέρασπις
sagai/	noun	σαγή
.	SENT	.
ti/s	pronoun	τις/τίς/τὶς
de\	particle	μηδέ/δέ/οὐδέ
poima/nwr	noun	ποιμάνωρ
e)/pesti	verb	ἔπειμι#1/ἔπειμι
ka)pidespo/zei	verb	ἐπιδεσπόζω
stratw=|	noun	στρατός
;	SENT	;
ou)/tinos	adjective	οὔτις
dou=loi	noun	δοῦλος
ke/klhntai	verb	καλέω
fwto\s	noun	φῶς/φώς
ou)	adverb	οὐκ/οὔπως/οὐ
d'	particle	οὐδέ/δέ/??
u(ph/kooi	adjective	ὑπήκους/ὑπήκοος
.	SENT	.
pw=s	adverb	πως/πῶς
a)\n	particle	ἄν
ou)=n	adverb	οὖν
me/noien	verb	μένω
a)/ndras	noun	ἀνήρ
polemi/ous	adjective	πολέμιος
e)ph/ludas	noun	ἔπηλυς
;	SENT	;
w(/ste	conjunction	ὥστε
*darei/ou	noun	Δαρεῖος
polu/n	adjective	πολύς
te	conjunction	τε/ὅτε
kai\	conjunction	???/καί
kalo\n	adjective	καλός
fqei=rai	verb	φθείρω
strato/n	noun	στρατός
.	SENT	.
deina/	adjective	δεινός
toi	particle	τοι
le/geis	verb	λέγω
i)o/ntwn	verb	εἰμί/εἶμι
toi=s	article	ὁ
tekou=si	verb	τίκτω
fronti/sai	verb	φροντίζω
.	SENT	.
a)ll'	conjunction	/ἀλλά/ἀλλα/ἀλλ̓
e)moi\	pronoun	ἐμός/ἐγώ
dokei=n	verb	δοκέω
ta/x'	adverb	τάχα
ei)/sh|	verb	εἴδομαι/εἰσίημι/εἶμι/οἶδα
pa/nta	pronoun	πᾶς
nhmerth=	adjective	νημερτής
lo/gon	noun	λόγος
.	SENT	.
tou=de	pronoun	ὅδε
ga\r	particle	γάρ
dra/mhma	noun	δράμημα
fwto\s	noun	φῶς/φώς
*persiko\n	adjective	Περσικός
pre/pei	verb	πρέπω
maqei=n	verb	μανθάνω
,	SENT	,
kai\	conjunction	???/καί
fe/rei	verb	φέρω
safe/s	adjective	σαφής
ti	pronoun	τις/τίς/τὶς
pra=gos	noun	πρᾶγος
e)sqlo\n	adjective	ἐσθλός
h)\	conjunction	ἤ
kako\n	adjective	κακός
klu/ein	verb	κλύω
.	SENT	.
w)=	interjection	ὦ
gh=s	noun	Γαῖα/γῆ
a(pa/shs	adjective	ἅπας
*)asia/dos	noun	Ἀσιάς
poli/smata	noun	πόλισμα
,	SENT	,
w)=	interjection	ὦ
*persi\s	noun	Περσίς
ai)=a	noun	γαῖα/αἶα
kai\	conjunction	???/καί
polu\s	adjective	πολύς
plou/tou	noun	πλοῦτος
limh/n	noun	λιμήν
,	SENT	,
w(s	conjunction	ὥς/ὡς
e)n	preposition	ἐν/εἰς
mia=|	adjective	εἷς
plhgh=|	noun	πληγή
kate/fqartai	verb	καταφθείρω
polu\s	adjective	πολύς
o)/lbos	noun	ὄλβος
,	SENT	,
to\	article	ὁ
*persw=n	noun	Πέρσης/Ρέρσης/πέρσης
d'	conjunction	δ̓/τε/δε/δέ
a)/nqos	noun	ἄνθος
oi)/xetai	verb	οἴχομαι
peso/n	verb	πίπτω
.	SENT	.
w)/moi	interjection	ὤμοι
,	SENT	,
kako\n	adjective	κακός
me\n	particle	μέν
prw=ton	adjective	πρότερος/πρῶτος
a)gge/llein	verb	ἀγγέλλω
kaka/	adjective	κακός
:	SENT	:
o(/mws	adverb	ὅμως
d'	particle	οὐδέ/δέ/??
a)na/gkh	noun	ἀνάγκη
pa=n	adjective	πᾶς
a)naptu/cai	verb	ἀναπτύσσω
pa/qos	noun	πάθος
,	SENT	,
*pe/rsai	noun	Πέρσης/πέρσης
:	SENT	:
strato\s	noun	στρατός
ga\r	particle	γάρ
pa=s	pronoun	πᾶς
o)/lwle	verb	ὄλλυμι
barba/rwn	noun	βάρβαρος
.	SENT	.
a)/ni'	adjective	ἄνιος
a)/nia	adjective	ἄνιος
kaka\	adjective	κακός
neo/kota	adjective	νεόκοτος
kai\	conjunction	???/καί
da/i'	adjective	δάιος/δᾷος
:.	SENT	·.
ai)ai=	interjection	αἰαῖ
,	SENT	,
diai/nesqe	verb	διαίνω
,	SENT	,
*pe/rsai	noun	Πέρσης/πέρσης
,	SENT	,
to/d'	pronoun	ὅδε
a)/xos	noun	ἄχος
klu/ontes	verb	κλύω
.	SENT	.
w(s	conjunction	ὥς/ὡς
pa/nta	pronoun	πᾶς
g'	particle	γε
e)/st'	verb	εἰμί
e)kei=na	pronoun	ἐκεῖνος
diapepragme/na	verb	διαπράσσω
:	SENT	:
au)to\s	pronoun	αὐτός
d'	particle	οὐδέ/δέ/??
a)e/lptws	adverb	ἄελπτος
no/stimon	adjective	νόστιμος
ble/pw	verb	βλέπω
fa/os	noun	φάος
.	SENT	.
h)=	adverb	ἦ/ἦ#2
makrobi/otos	adjective	μακροβίοτος
o(/de	pronoun	ὅδε
ge/	particle	γε
tis	pronoun	τις/τίς/τὶς
ai)w\n	noun	αἰών
e)fa/nqh	verb	φαίνω
geraioi=s	adjective	γεραιός
,	SENT	,
a)kou/ein	verb	ἀκούω
to/de	pronoun	ὅδε
ph=m'	noun	πῆμα
a)/elpton	adjective	ἄελπτος
.	SENT	.
kai\	conjunction	???/καί
mh\n	particle	μήν
parw/n	verb	πάρειμι
ge	adverb	γε
kou)	adverb	οὐ
lo/gous	noun	λογός/λόγος
a)/llwn	adjective	ἄλλος
klu/wn	verb	κλύω
,	SENT	,
*pe/rsai	noun	Πέρσης/πέρσης
,	SENT	,
fra/saim'	verb	φράζω
a)\n	particle	ἄν
oi(='	adjective	οἷος
e)porsu/nqh	verb	πορσύνω
kaka/	adjective	κακός
.	SENT	.
o)tototoi=	interjection	ὀτοτοῖ
,	SENT	,
ma/tan	adverb	μάτην
ta\	article	ὁ/τίς
polla\	adjective	πολύς
be/lea	noun	βέλος
pammigh=	adjective	παμμιγής
ga=s	noun	γῆ
a)p'	preposition	ἀπο/ἀπό
*)asi/dos	adjective	Ἀσίς
h)=lqe	verb	ἔρχομαι
da/|	unknown	unknown
-	SENT	-
an	adjective	δάιος/πατρῷος
e)f'	preposition	ἐπί
*(ella/da	proper	Ἑλλάς
xw/ran	noun	χώρα
.	SENT	.
plh/qousi	verb	πλήθω
nekrw=n	adjective	νεκρός
duspo/tmws	adverb	δύσποτμος
e)fqarme/nwn	verb	φθείρω
*salami=nos	noun	Σαλαμίς/σαλαμίς
a)ktai\	noun	ἀκτή
pa=s	adjective	πᾶς
te	particle	τε/??/οὔτε
pro/sxwros	adjective	πρόσχωρος
to/pos	noun	τόπος
.	SENT	.
o)tototoi=	interjection	ὀτοτοῖ
,	SENT	,
fi/lwn	adjective	φίλος
a(li/dona	adjective	ἁλίδονος
me/lea	noun	μέλος
polubafh=	adjective	πολυβαφής
katqano/nta	verb	καταθνήσκω
le/geis	verb	λέγω
fe/re	verb	φέρω
-	SENT	-
sqai	verb	φέρω/ἕπομαι
pla/gkt'	adjective	πλαγκτός
e)n	preposition	ἐν/εἰς
dipla/kessin	noun	δίπλαξ
.	SENT	.
ou)de\n	pronoun	οὐδείς
ga\r	particle	γάρ
h)/rkei	verb	αἴρω/ἀρκέω
to/ca	noun	τόξον
,	SENT	,
pa=s	pronoun	πᾶς
d'	particle	οὐδέ/δέ/??
a)pw/lluto	verb	ἀπόλλυμι
strato\s	noun	στρατός
damasqei\s	verb	δαμάζω
nai/+oisin	adjective	νήιος
e)mbolai=s	noun	ἐμβολή
i)/uz'	verb	ἰύζω
a)/potmon	adjective	ἄποτμος
*pe/rsais	noun	Πέρσης/πέρσης
dusaianh=	adjective	δυσαιανής
boa\n	noun	βοή
da/|ois	verb	δαίω
,	SENT	,
w(s	conjunction	ὥς/ὡς
pa/nta	pronoun	πᾶς
pagka/kws	adverb	πάγκακος
e)/fqisan	verb	φθίω
:	SENT	:
ai)ai=	interjection	αἰαῖ
stratou=	noun	στρατός
fqare/ntos	verb	φθείρω
.	SENT	.
w)=	interjection	ὦ
plei=ston	adjective	πλεῖστος/πολύς
e)/xqos	noun	ἔχθος
o)/noma	noun	ὄνομα
*salami=nos	noun	Σαλαμίς/σαλαμίς
klu/ein	verb	κλύω
.	SENT	.
feu=	interjection	φεῦ
,	SENT	,
tw=n	article	ὁ/ὅς
*)aqhnw=n	noun	̓ἀθῆναι/Ἀθῆναι
w(s	conjunction	ὥς/ὡς
ste/nw	verb	στένω/στενόω
memnhme/nos	verb	μιμνῄσκω/μιμνήσκω
.	SENT	.
stugnai/	adjective	στυγνός
g'	particle	γε
*)aqa=nai	noun	Ἀθῆναι
da/|ois	verb	δαίω
:	SENT	:
memnh=sqai/	verb	μιμνήσκω
toi	particle	τοι
pa/ra	verb	πάρειμι/πάρα
w(s	conjunction	ὥς/ὡς
polla\s	adjective	πολύς
*persi/dwn	noun	Περσίς
ma/tan	adverb	μάτην
e)/ktisan	verb	κτίζω/ἐκτίνω
eu)/nidas	noun	εὖνις
h)d'	conjunction	ἠδέ/ἠδη
a)na/ndrous	adjective	ἄνανδρος
.	SENT	.
sigw=	verb	σιγάω/σιγάζω
pa/lai	adverb	πάλαι
du/sthnos	adjective	δύστηνος
e)kpeplhgme/nh	verb	ἐκπλήσσω/ἐκπλήγνυμι
kakoi=s	adjective	κακός
:	SENT	:
u(perba/llei	verb	ὑπερβάλλω
ga\r	particle	γάρ
h(/de	pronoun	ὅδε
sumfora\	noun	συμφορά
to\	article	ὁ
mh/te	adverb	μήτε
le/cai	verb	λέγω
mh/t'	conjunction	μήτις/μήτε/μήτ̓
e)rwth=sai	verb	ἐρωτάω
pa/qh	noun	πάθη/πάθος
.	SENT	.
o(/mws	adverb	ὅμως
d'	particle	οὐδέ/δέ/??
a)na/gkh	noun	ἀνάγκη
phmona\s	noun	πημονή
brotoi=s	noun	βροτός
fe/rein	verb	φέρω
qew=n	noun	θέος/θεεός/θέα/θεά/θεός/θεὸς
dido/ntwn	verb	δίδωμι
:	SENT	:
pa=n	pronoun	πᾶς
d'	particle	οὐδέ/δέ/??
a)naptu/cas	verb	ἀναπτύσσω
pa/qos	noun	πάθος
le/con	verb	λέγω
katasta/s	verb	καθίστημι
,	SENT	,
kei)	conjunction	εἰ
ste/neis	verb	στένω
kakoi=s	adjective	κακός
o(/mws	adverb	ὅμως
.	SENT	.
ti/s	pronoun	τις/τίς/τὶς
ou)	adverb	οὐκ/οὔπως/οὐ
te/qnhke	verb	θνῄσκω/θνήσκω
,	SENT	,
ti/na	pronoun	ὁς/τις/τίς
de\	particle	μηδέ/δέ/οὐδέ
kai\	conjunction	???/καί
penqh/somen	verb	πενθέω
tw=n	article	ὁ/ὅς
a)rxelei/wn	adjective	ἀρχέλαος
,	SENT	,
o(/st'	pronoun	ὅστε
e)pi\	preposition	ἐπί
skhptouxi/a|	noun	σκηπτουχία
taxqei\s	verb	τάσσω
a)/nandron	adjective	ἄνανδρος
ta/cin	noun	τάξις
h)rh/mou	verb	ἐρημόω
qanw/n	verb	θνήσκω
;	SENT	;
*ce/rchs	noun	Ξέρξης/Ξήρξης
me\n	particle	μέν
au)to\s	pronoun	αὐτός
zh=|	verb	ζῶ/ζάω/ζέω
te	conjunction	τε/ὅτε
kai\	conjunction	???/καί
ble/pei	verb	βλέπω
fa/os	noun	φάος
.	SENT	.
e)moi=s	adjective	ἐμός
me\n	particle	μέν
ei)=pas	verb	λέγω/εἶπον
dw/masin	noun	δῶμα
fa/os	noun	φάος
me/ga	adjective	μέγας
kai\	conjunction	???/καί
leuko\n	adjective	λευκός
h)=mar	noun	ἦμαρ
nukto\s	noun	νύξ
e)k	preposition	ἐκ
melagxi/mou	adjective	μελάγχιμος
.	SENT	.
*)artemba/rhs	noun	Ἀρτεμβάρας/Ἀρτεμβάρης
de\	particle	μηδέ/δέ/οὐδέ
muri/as	adjective	μυρίος
i(/ppou	noun	ἵππος
brabeu\s	noun	βραβεύς
stu/flous	adjective	στύφλος/στυφελός
par'	preposition	παρα/παρά/παρὰ
a)kta\s	noun	ἀκτή
qei/netai	verb	θείνω
*silhniw=n	noun	Σιληνίαι
.	SENT	.
xw)	article	ὁ
xili/arxos	noun	χιλίαρχος
*dada/khs	noun	Δαδάκης
plhgh=|	noun	πληγή
doro\s	noun	δόρυ
ph/dhma	noun	πήδημα
kou=fon	adjective	κοῦφος
e)k	preposition	ἐκ
new\s	noun	ναῦς/νεώς/ναός
a)fh/lato	verb	ἀφ́αλλομαι/ἀπάλλομαι
:	SENT	:
*tena/gwn	noun	Τενάγων
t'	particle	τε
a)risteu\s	noun	ἀριστεύς
*baktri/wn	adjective	Βάκτριος
i)qaigenh\s	adjective	ἰθαγενής
qalasso/plhkton	adjective	θαλασσόπληκτος
nh=son	noun	νῆσος
*ai)/antos	noun	Αἴας/αἴας
polei=	adjective	πολύς
.	SENT	.
*li/laios	noun	Λίλαιος
,	SENT	,
*)arsa/mhs	noun	Αρσάμης/Ἀρσάμης
te	particle	τε/??/οὔτε
k*)argh/sths	noun	Ἀργήστης
tri/tos	adjective	τρίτος
,	SENT	,
oi(/d'	pronoun	ὅδε
a)mfi\	preposition	ἀμφί
nh=son	noun	νῆσος
th\n	article	ὁ
peleioqre/mmona	adjective	πελειοθρέμμων
dinou/menoi	verb	δινέω/δινόω/δινεύω
'	SENT	̓
ku/risson	verb	κυρίζω/κυρίσσω
i)sxura\n	adjective	ἰσχυρός
xqo/na	noun	χθών
:	SENT	:
phgai=s	adjective	πηγός
te	particle	τε/??/οὔτε
*nei/lou	noun	Νεῖλος
geitonw=n	verb	γειτονέω
*ai)gupti/ou	adjective	Αἰγύπτιος/Αἰγυπτιός
*)arkteu/s	noun	Ἀρκτεύς
,	SENT	,
*)adeu/hs	noun	Ἀδεύης
,	SENT	,
kai\	conjunction	???/καί
feressa/khs	adjective	φερεσσακής
tri/tos	adjective	τρίτος
*farnou=xos	noun	Φαρνοῦχος
,	SENT	,
oi(/de	pronoun	ὅδε
nao\s	noun	ναῦς/ναός
e)k	preposition	ἐκ
mia=s	adjective	εἷς
pe/son	verb	πίπτω
.	SENT	.
*xruseu\s	adjective	Χρυσεύς
*ma/tallos	noun	Μάταλλος
murio/ntarxos	noun	μυριόνταρχος
qanw/n	verb	θνήσκω
,	SENT	,
i(/ppou	noun	ἵππος
melai/nhs	adjective	μέλας
h(gemw\n	noun	ἡγεμών
trismuri/as	adjective	τρισμύριοι
,	SENT	,
purra\n	adjective	πυρρός
zaplhqh=	adjective	ζαπληθής
da/skion	adjective	δάσκιος
geneia/da	noun	γενειάς
e)/tegg'	verb	τέγγω
,	SENT	,
a)mei/bwn	verb	ἀμείβω
xrw=ta	noun	χρώς
porfure/a|	adjective	πορφύρεος
bafh=|	noun	βαφή/βαφεύς
.	SENT	.
kai\	conjunction	???/καί
*ma=gos	noun	Μᾶγος
*)/arabos	adjective	Ἄραβος
,	SENT	,
*)arta/bhs	noun	Ἀρτάβης
te	particle	τε/??/οὔτε
*ba/ktrios	adjective	Βάκτριος
,	SENT	,
sklhra=s	adjective	σκληρός
me/toikos	noun	μέτοικος
gh=s	noun	Γαῖα/γῆ
,	SENT	,
e)kei=	adverb	ἐκεῖ
kate/fqito	verb	καταφθίω/καταφθίνω
.	SENT	.
*)/amistris	noun	Ἄμιστρις
*)amfistreu/s	noun	Ἀμιστρεύς
te	particle	τε/??/οὔτε
polu/ponon	adjective	πολύπονος
do/ru	noun	δόρυ
nwmw=n	verb	νωμάω
,	SENT	,
o(/	pronoun	/ὅ/ὅστις/ὁς/ὅς/ὁ
t'	particle	τε
e)sqlo\s	adjective	ἐσθλός
*)ario/mardos	noun	Ἀριόμαρδος
*sa/rdesi	noun	Σάρδεις
pe/nqos	noun	πένθος
parasxw/n	verb	παρέχω
,	SENT	,
*seisa/mhs	noun	Σεισάμης
q'	particle	τε
o(	article	ὁ
*mu/sios	adjective	Μύσιος
,	SENT	,
*qa/rubi/s	noun	Θάρυβις
te	particle	τε/??/οὔτε
penth/konta	adjective	πεντήκοντα
penta/kis	adverb	πεντάκις
new=n	noun	ναῦς/νεώς/ναός/νέα
tago/s	noun	ταγός
,	SENT	,
ge/nos	noun	γένος
*lurnai=os	adjective	Λυρναῖος
,	SENT	,
eu)eidh\s	adjective	εὐειδής
a)nh/r	noun	ἀνήρ
,	SENT	,
kei=tai	verb	κεῖμαι/κέω
qanw\n	verb	θνήσκω
dei/laios	adjective	δείλαιος
ou)	adverb	οὐκ/οὔπως/οὐ
ma/l'	adverb	μάλα
eu)tuxw=s	adverb	εὐτυχής
:	SENT	:
*sue/nnesi/s	noun	Συέννεσις
te	particle	τε/??/οὔτε
prw=tos	adjective	πρότερος/πρῶτος
ei)s	preposition	εἰς
eu)yuxi/an	noun	εὐψυχία
,	SENT	,
*kili/kwn	noun	κίλιξ/Κίλιξ
a)/parxos	noun	ἄπαρχος
,	SENT	,
ei(=s	adjective	εἷς
a)nh\r	noun	ἀνήρ
plei=ston	adjective	πλεῖστος/πολύς
po/non	noun	πόνος
e)xqroi=s	adjective	ἐχθρός
parasxw/n	verb	παρέχω
eu)klew=s	adverb	εὐκλεής
a)pw/leto	verb	ἀπόλλυμι
.	SENT	.
toso/nde	pronoun	τοσόσδε
tagw=n	noun	ταγός
nu=n	adverb	νῦν#1/νῦν
u(pemnh/sqhn	verb	ὑπομνάομαι/ὑπομιμνήσκω
pe/ri	preposition	περί
.	SENT	.
pollw=n	adjective	πολύς
paro/ntwn	verb	πάρειμι
d'	particle	οὐδέ/δέ/??
o)li/g'	adjective	ὀλίγος
a)pagge/llw	verb	ἀπαγγέλλω
kaka/	adjective	κακός
.	SENT	.
ai)ai=	interjection	αἰαῖ
,	SENT	,
kakw=n	adjective	κακός
u(/yista	adjective	ὕψιστος
dh\	adverb	δή
klu/w	verb	κλύω
ta/de	pronoun	ὅδε
,	SENT	,
ai)/sxh	noun	αἶσχος
te	particle	τε/??/οὔτε
*pe/rsais	noun	Πέρσης/πέρσης
kai\	conjunction	???/καί
lige/a	adjective	λιγύς
kwku/mata	noun	κώκυμα
.	SENT	.
a)ta\r	particle	ἀτάρ
fra/son	verb	φράζω
moi	pronoun	τις/ἐγώ
tou=t'	adjective	οὗτος
a)nastre/yas	verb	ἀναστρέφω
pa/lin	adverb	πάλιν
:	SENT	:
po/son	pronoun	πόσος
de\	particle	μηδέ/δέ/οὐδέ
plh=qos	noun	πλῆθος
h)=n	verb	είμί/εἰμί#1/εἰμί/ἠμί
new=n	noun	ναῦς/νεώς/ναός/νέα
*(ellhni/dwn	adjective	Ἑλληνίς
,	SENT	,
w(/st'	conjunction	ὥστε
a)ciw=sai	verb	ἀξιόω/ἀξιάω
*persikw=|	adjective	Περσικός/περσικός
strateu/mati	noun	στράτευμα
ma/xhn	noun	μαχή/μάχη
suna/yai	verb	συνάπτω
nai/+oisin	adjective	νήιος
e)mbolai=s	noun	ἐμβολή
;	SENT	;
plh/qous	noun	πλῆθος
me\n	particle	μέν
a)\n	particle	ἄν
sa/f'	adverb	σάφα
i)/sq'	verb	εἰμί/οἶδα
e(/kati	adverb	ἕκητι
ba/rbaron	adjective	βάρβαρος
nausi\n	noun	ναῦς
krath=sai	verb	κρατέω
.	SENT	.
kai\	conjunction	???/καί
ga\r	particle	γάρ
*(/ellhsin	noun	Ἕλλην/῞ἕλλην
me\n	adverb	μέν
h)=n	verb	είμί/εἰμί#1/εἰμί/ἠμί
o(	article	ὁ
pa=s	adjective	πᾶς
a)riqmo\s	noun	ἀριθμός
e)s	preposition	εἰς
triaka/das	noun	τριακάς
de/ka	adjective	δέκα
naw=n	noun	ναῦς/ναός
,	SENT	,
deka\s	noun	δεκάς
d'	particle	οὐδέ/δέ/??
h)=n	verb	είμί/εἰμί#1/εἰμί/ἠμί
tw=nde	pronoun	ὅδε
xwri\s	preposition	χωρίς/χωρὶς
e)/kkritos	adjective	ἔκκριτος
:	SENT	:
*ce/rch|	noun	Ξέρξης
de/	particle	δέ/οὐδέ
,	SENT	,
kai\	conjunction	???/καί
ga\r	adverb	γάρ
oi)=da	verb	εἴδω/οἶδα
,	SENT	,
xilia\s	noun	χιλιάς
me\n	particle	μέν
h)=n	verb	είμί/εἰμί#1/εἰμί/ἠμί
w(=n	pronoun	ὅς
h)=ge	verb	ἄγω
plh=qos	noun	πλῆθος
,	SENT	,
ai(	article	ὁ
d'	particle	οὐδέ/δέ/??
u(pe/rkopoi	adjective	ὑπέρκοπος
ta/xei	noun	τάχος
e(kato\n	adjective	ἑκατόν
di\s	adverb	δίς
h)=san	verb	εἰμί#1/εἰμί
e(pta/	adjective	ἑπτά
q'	particle	τε
:	SENT	:
w(=d'	adverb	ὧδε
e)/xei	verb	ἐχώ/ἔχω/χέω/χάω
lo/gos	noun	λόγος
.	SENT	.
mh/	conjunction	μή
soi	pronoun	σοι/σύ
dokou=men	verb	δοκόω/δοκέω
th=|de	pronoun	ὅδε
leifqh=nai	verb	λείπω
ma/xh|	noun	μαχή/μάχη
;	SENT	;
a)ll'	conjunction	/ἀλλά/ἀλλα/ἀλλ̓
w(=de	adverb	ὧδε
dai/mwn	noun	δαίμων
tis	pronoun	τις/τίς/τὶς
kate/fqeire	verb	καταφθείρω
strato/n	noun	στρατός
,	SENT	,
ta/lanta	noun	τάλαντον
bri/sas	verb	βρίθω/βρίζω
ou)k	adverb	οὐ
i)sorro/pw|	adjective	ἰσόρροπος
tu/xh|	noun	τύχη
.	SENT	.
qeoi\	noun	θεός
po/lin	noun	πόλις
sw/|zousi	verb	σώζω
*palla/dos	noun	παλλάς/Παλλάς
qea=s	noun	θεά
.	SENT	.
e)/t'	adverb	ἔτι
a)=r'	particle	ἆρα
*)aqhnw=n	noun	̓ἀθῆναι/Ἀθῆναι
e)/st'	verb	εἰμί
a)po/rqhtos	adjective	ἀπόρθητος
po/lis	noun	πόλις/πόόλις
;	SENT	;
a)ndrw=n	noun	ἀνήρ
ga\r	particle	γάρ
o)/ntwn	verb	εἰμί#1/εἰμί
e(/rkos	noun	ἕρκος
e)sti\n	verb	εἰμί#1/εἰμί
a)sfale/s	adjective	ἀσφαλής
.	SENT	.
a)rxh\	noun	ἀρχή
de\	particle	μηδέ/δέ/οὐδέ
nausi\	noun	ναῦς
sumbolh=s	noun	συμβολεύς/συμβολή
ti/s	pronoun	τις/τίς/τὶς
h)=n	verb	είμί/εἰμί#1/εἰμί/ἠμί
,	SENT	,
fra/son	verb	φράζω
:	SENT	:
ti/nes	pronoun	τις/τίς/τ́ις
kath=rcan	verb	κατάρχω
,	SENT	,
po/teron	adjective	πότερος
*(/ellhnes	noun	Ἕλλην/῞ἕλλην
,	SENT	,
ma/xhs	noun	μαχή/μάχη
,	SENT	,
h)\	conjunction	ἤ
pai=s	noun	παῖς
e)mo/s	adjective	ἐμός
,	SENT	,
plh/qei	noun	πλῆθος
katauxh/sas	verb	καταυχέω
new=n	noun	ναῦς/νεώς/ναός/νέα
;	SENT	;
h)=rcen	verb	ἔρδω/ἄρχω
me/n	particle	μέν
,	SENT	,
w)=	interjection	ὦ
de/spoina	noun	δέσποινα
,	SENT	,
tou=	article	ὁ/ὅς/τὁ/ὀ
panto\s	adjective	πᾶς
kakou=	adjective	κακός/κακός·
fanei\s	verb	φαίνω
a)la/stwr	noun	ἀλάστωρ
h)\	conjunction	ἤ
kako\s	adjective	κακός
dai/mwn	noun	δαίμων
poqe/n	adverb	ποθεν
.	SENT	.
a)nh\r	noun	ἀνήρ
ga\r	particle	γάρ
*(/ellhn	noun	Ἕλλην
e)c	preposition	ἐκ
*)aqhnai/wn	noun	Ἀθήναια/Ἀθηναῖος/Ἀθήναιον/Ἀθήναιος
stratou=	noun	στρατός
e)lqw\n	verb	ἔρχομαι
e)/lece	verb	λέγω
paidi\	noun	παῖς
sw=|	adjective	σός
*ce/rch|	proper	Ξέρξης
ta/de	pronoun	ὅδε
,	SENT	,
w(s	adverb	ὡς#2/ʽὡς/ὥς/ὡς
ei)	conjunction	εἰ
melai/nhs	adjective	μέλας
nukto\s	noun	νύξ
i(/cetai	verb	ἱκνέομαι/ἵζω
kne/fas	noun	κνέφας
,	SENT	,
*(/ellhnes	noun	Ἕλλην/῞ἕλλην
ou)	adverb	οὐκ/οὔπως/οὐ
menoi=en	verb	μένω
,	SENT	,
a)lla\	conjunction	ἀλλά/ἀλλὰ
se/lmasin	noun	σέλμα
naw=n	noun	ναῦς/ναός
e)panqoro/ntes	verb	ἀναθρῴσκω/ἐπαναθρῳσκω
a)/llos	adjective	ἄλλος
a)/llose	adverb	ἄλλοτε/ἄλλοσε
drasmw=|	noun	δρασμός
krufai/w|	adjective	κρυφαῖος/κρυπτός
bi/oton	noun	βίοτος
e)kswsoi/ato	verb	ἐκσῴζω
.	SENT	.
o(	article	ὁ
d'	particle	οὐδέ/δέ/??
eu)qu\s	adverb	εὐθύς
w(s	adverb	ὡς#2/ʽὡς/ὥς/ὡς
h)/kousen	verb	ἀκούω
,	SENT	,
ou)	adverb	οὐκ/οὔπως/οὐ
cunei\s	verb	συνίημι
do/lon	noun	δόλος
*(/ellhnos	noun	Ἕλλην
a)ndro\s	noun	ἀνήρ
ou)	adverb	οὐκ/οὔπως/οὐ
de\	adverb	δέ/οὐ
to\n	article	ὁ/τὸν
qew=n	noun	θέος/θεεός/θέα/θεά/θεός/θεὸς
fqo/non	noun	φθόνος
,	SENT	,
pa=sin	pronoun	πᾶς
profwnei=	verb	προφωνέω
to/nde	pronoun	ὅδε
naua/rxois	noun	ναύαρχος
lo/gon	noun	λόγος
,	SENT	,
eu)=t'	conjunction	εὖτε
a)\n	adverb	ἀν/ἄν/ἐάν
fle/gwn	verb	φλέγω
a)kti=sin	noun	ἀκτίς
h(/lios	noun	ἥλιος
xqo/na	noun	χθών
lh/ch|	verb	λήγω/λαγχάνω
,	SENT	,
kne/fas	noun	κνέφας
de\	particle	μηδέ/δέ/οὐδέ
te/menos	noun	τέμενος
ai)qe/ros	noun	αἰθήρ
la/bh|	verb	λαμβάνω
,	SENT	,
ta/cai	verb	τάσσω
new=n	noun	ναῦς/νεώς/ναός/νέα
sti=fos	noun	στῖφος
me\n	particle	μέν
e)n	preposition	ἐν/εἰς
stoi/xois	noun	στοῖχος
trisi\n	adjective	τρεῖς
e)/kplous	noun	ἔκπλοος
fula/ssein	verb	φυλάσσω/φυλάζω
kai\	conjunction	???/καί
po/rous	noun	πόρος
a(lirro/qous	adjective	ἁλίρροθος
,	SENT	,
a)/llas	adjective	ἄλλος
de\	particle	μηδέ/δέ/οὐδέ
ku/klw|	noun	κύκλος
nh=son	noun	νῆσος
*ai)/antos	noun	Αἴας/αἴας
pe/ric	adverb	πέριξ
:	SENT	:
w(s	adverb	ὡς#2/ʽὡς/ὥς/ὡς
ei)	conjunction	εἰ
mo/ron	noun	μόρον/μόρος
feucoi/aq'	verb	φεύζω/φεύγω
*(/ellhnes	noun	Ἕλλην/῞ἕλλην
kako/n	adjective	κακός
,	SENT	,
nausi\n	noun	ναῦς
krufai/ws	adjective	κρυφαῖος
drasmo\n	noun	δρασμός
eu(ro/ntes	verb	εὑρίσκω
tina/	pronoun	τις/τὶς
,	SENT	,
pa=sin	pronoun	πᾶς
ste/resqai	verb	στέρομαι
krato\s	noun	κράς
h)=n	verb	είμί/εἰμί#1/εἰμί/ἠμί
prokei/menon	verb	πρόκειμαι
.	SENT	.
tosau=t'	adjective	τοσοῦτος
e)/lece	verb	λέγω
ka/rq'	adverb	κάρτα
u(p'	preposition	ὑπο/ὑπό
eu)qu/mou	adjective	εὔθυμος
freno/s	noun	πρήν/φρήν
:	SENT	:
ou)	adverb	οὐκ/οὔπως/οὐ
ga\r	adverb	γάρ
to\	article	ὁ
me/llon	verb	μέλλω
e)k	preposition	ἐκ
qew=n	noun	θέος/θεεός/θέα/θεά/θεός/θεὸς
h)pi/stato	verb	ἐπίσταμαι
.	SENT	.
oi(	pronoun	/οὗ/ὅς/ἕ/ὁ
d'	particle	οὐδέ/δέ/??
ou)k	adverb	οὐ
a)ko/smws	adverb	ἀκόσμως/ἄκοσμος
,	SENT	,
a)lla\	conjunction	ἀλλά/ἀλλὰ
peiqa/rxw|	adjective	πείθαρχος
freni\	noun	πρήν/φρήν
dei=pno/n	noun	δεῖπνον
t'	particle	τε
e)porsu/nonto	verb	πορσύνω
,	SENT	,
nauba/ths	noun	ναυβάτης
t'	particle	τε
a)nh\r	noun	ἀνήρ
tropou=to	verb	τροπόω
kw/phn	noun	κώπη
skalmo\n	noun	σκαλμός
a)mf'	preposition	ἀμφί
eu)h/retmon	adjective	εὐήρετμος
.	SENT	.
e)pei\	conjunction	ἐπεί
de\	adverb	δέ/οὐ
fe/ggos	noun	φέγγος
h(li/ou	noun	ἥλιος/ἤλιος
kate/fqito	verb	καταφθίω/καταφθίνω
kai\	conjunction	???/καί
nu\c	noun	νύξ
e)ph/|ei	verb	ἔπειμι
,	SENT	,
pa=s	pronoun	πᾶς
a)nh\r	noun	ἀνήρ
kw/phs	verb	κωπάω
a)/nac	noun	ἄναξ
e)s	preposition	εἰς
nau=n	noun	ναῦς
e)xw/rei	verb	χωρέω
pa=s	pronoun	πᾶς
q'	particle	τε
o(/plwn	noun	ὅπλον
e)pista/ths	noun	ἐπιστάτη/ἐπιστάτης
:	SENT	:
ta/cis	noun	τάξις
de\	particle	μηδέ/δέ/οὐδέ
ta/cin	noun	τάξις
pareka/lei	verb	παρακαλέω
new\s	noun	ναῦς/νεώς/ναός
makra=s	adjective	μακρός
:	SENT	:
ple/ousi	verb	πλέω
d'	particle	οὐδέ/δέ/??
w(s	adverb	ὡς#2/ʽὡς/ὥς/ὡς
e(/kastos	adjective	ἕκαστος
h)=n	verb	είμί/εἰμί#1/εἰμί/ἠμί
tetagme/nos	verb	τάσσω
,	SENT	,
kai\	conjunction	???/καί
pa/nnuxoi	adjective	πάννυχος
dh\	adverb	δή
dia/ploon	adjective	διάπλοος
kaqi/stasan	verb	καθιστάω/καθίστημι
naw=n	noun	ναῦς/ναός
a)/naktes	noun	ἄναξ
pa/nta	adjective	/πα~ς/πᾶς
nautiko\n	adjective	ναυτικός
lew/n	noun	λαός
.	SENT	.
kai\	conjunction	???/καί
nu\c	noun	νύξ
e)xw/rei	verb	χωρέω
,	SENT	,
kou)	adverb	οὐ
ma/l'	adverb	μάλα
*(ellh/nwn	noun	Ἕλλην/῞ἕλλην
strato\s	noun	στρατός
krufai=on	adjective	κρυφαῖος
e)/kploun	verb	ἐκπλέω
ou)damh=|	adverb	οὐδαμῇ/οὐδαμός
kaqi/stato	verb	καθίστημι
:	SENT	:
e)pei/	conjunction	ἐπεί
ge	particle	γε
me/ntoi	particle	μέντοι
leuko/pwlos	adjective	λευκόπωλος
h(me/ra	noun	ἡμέρα
pa=san	adjective	πᾶς
kate/sxe	verb	κατέχω
gai=an	noun	γαῖα
eu)feggh\s	adjective	εὐφεγγής
i)dei=n	verb	ἰδέω/εἶδον/ὁράω
,	SENT	,
prw=ton	adjective	πρότερος/πρῶτος
me\n	particle	μέν
h)xh=|	noun	ἠχή
ke/lados	noun	κέλαδος
*(ellh/nwn	noun	Ἕλλην/῞ἕλλην
pa/ra	preposition	παρά
molphdo\n	adverb	μολπηδόν
hu)fh/mhsen	verb	εὐφημέω
,	SENT	,
o)/rqion	adjective	ὄρθιος
d'	particle	οὐδέ/δέ/??
a(/ma	adverb	ἅμα
a)nthla/lace	verb	ἀνταλαλάζω
nhsiw/tidos	noun	νησιώτης
pe/tras	noun	πέτρα
h)xw/	noun	ἠχώ
:	SENT	:
fo/bos	noun	φόβος
de\	particle	μηδέ/δέ/οὐδέ
pa=si	adjective	πα~ς/πᾶς
barba/rois	noun	βάρβαρος
parh=n	verb	πάρειμι/πάρειμι#1
gnw/mhs	noun	γνώμη
a)posfalei=sin	verb	ἀποσφάλλω
:	SENT	:
ou)	adverb	οὐκ/οὔπως/οὐ
ga\r	particle	γάρ
w(s	adverb	ὡς#2/ʽὡς/ὥς/ὡς
fugh=|	noun	φυγή
paia=n'	noun	παιάν/Παιάν
e)fu/mnoun	verb	ἐφυμνέω
semno\n	adjective	σεμνός
*(/ellhnes	noun	Ἕλλην/῞ἕλλην
to/te	adverb	τότε
,	SENT	,
a)ll'	conjunction	/ἀλλά/ἀλλα/ἀλλ̓
e)s	preposition	εἰς
ma/xhn	noun	μαχή/μάχη
o(rmw=ntes	verb	ὁρμάζω/ὁρμάω
eu)yu/xw|	adjective	εὔψυχος
qra/sei	noun	θράσις/θράσος
:	SENT	:
sa/lpigc	noun	σάλπιγξ
d'	particle	οὐδέ/δέ/??
a)u+th=|	noun	ἀυτή
pa/nt'	adjective	πα~ς/πᾶς/π͂ας
e)kei=n'	adjective	ἐκεῖνος
e)pe/flegen	verb	ἐπιφλέγω
.	SENT	.
eu)qu\s	adverb	εὐθύς
de\	particle	μηδέ/δέ/οὐδέ
kw/phs	noun	κώπη
r(oqia/dos	noun	ῥοθιάς
cunembolh=|	noun	συνεμβολή
e)/paisan	verb	παίω/ἐπαείδω
a(/lmhn	noun	ἅλμη
bru/xion	adjective	βρύχιος
e)k	preposition	ἐκ
keleu/matos	noun	κέλευμα/κέλευθος
,	SENT	,
qow=s	adverb	θοός
de\	particle	μηδέ/δέ/οὐδέ
pa/ntes	pronoun	πᾶς
h)=san	verb	εἰμί#1/εἰμί
e)kfanei=s	adverb	ἐκφανής
i)dei=n	verb	ἰδέω/εἶδον/ὁράω
.	SENT	.
to\	article	ὁ
decio\n	adjective	δεξιός
me\n	adverb	μέν
prw=ton	adjective	πρότερος/πρῶτος
eu)ta/ktws	adjective	εὔτακτος
ke/ras	noun	κέρας
h(gei=to	verb	ἁγέομαι/ἡγέομαι
ko/smw|	noun	κόσμος
,	SENT	,
deu/teron	adjective	δεύτερος
d'	particle	οὐδέ/δέ/??
o(	article	ὁ
pa=s	adjective	πᾶς
sto/los	noun	στόλος
e)pecexw/rei	verb	ἐπεκχωρέω
,	SENT	,
kai\	conjunction	???/καί
parh=n	verb	πάρειμι/πάρειμι#1
o(mou=	adverb	ὁμοῦ
klu/ein	verb	κλύω
pollh\n	adjective	πολύς
boh/n	noun	βοή
,	SENT	,
"	SENT	"
w)=	interjection	ὦ
pai=des	noun	παίς/παῖς
*(ellh/nwn	noun	Ἕλλην/῞ἕλλην
i)/te	verb	εἶμι
,	SENT	,
e)leuqerou=te	verb	ἐλευθερόω
patri/d'	noun	πατρίς
,	SENT	,
e)leuqerou=te	verb	ἐλευθερόω
de\	particle	μηδέ/δέ/οὐδέ
pai=das	noun	παῖς
,	SENT	,
gunai=kas	noun	γυνή
,	SENT	,
qew=n	noun	θέος/θεεός/θέα/θεά/θεός/θεὸς
te/	particle	τε
patrw/|wn	adjective	πατρῷος
e(/dh	noun	ἕδος
,	SENT	,
qh/kas	noun	θήκη
te	particle	τε/??/οὔτε
progo/nwn	noun	πρόγονος
:	SENT	:
nu=n	adverb	νῦν#1/νῦν
u(pe\r	preposition	ὑπέρ
pa/ntwn	adjective	πᾶς
a)gw/n	noun	ἀγών
.	SENT	.
kai\	conjunction	???/καί
mh\n	adverb	μήν/μήv
par'	preposition	παρα/παρά/παρὰ
h(mw=n	pronoun	σύ/ἐγώ/ἡμεῖς
*persi/dos	noun	Περσίς
glw/sshs	noun	γλῶσσα
r(o/qos	noun	ῥόθος
u(phnti/aze	verb	ὑπαντιάζω
,	SENT	,
kou)ke/t'	adverb	οὐκέτι
h)=n	verb	είμί/εἰμί#1/εἰμί/ἠμί
me/llein	verb	μέλλω
a)kmh/	noun	ἀκμή
.	SENT	.
eu)qu\s	adverb	εὐθύς
de\	particle	μηδέ/δέ/οὐδέ
nau=s	noun	ναῦς
e)n	preposition	ἐν/εἰς
nhi\	noun	ναῦς
xalkh/rh	adjective	χαλκήρης
sto/lon	noun	στόλος
e)/paisen	verb	παίω/ἐπαείδω
:	SENT	:
h)=rce	verb	ἔρδω/ἄρχω
d'	particle	οὐδέ/δέ/??
e)mbolh=s	noun	ἐμβολή/ἐμβολεύς
*(ellhnikh\	adjective	Ἑλληνικός
nau=s	noun	ναῦς
,	SENT	,
ka)poqrau/ei	verb	ἀποθραύω
pa/nta	pronoun	πᾶς
*foini/sshs	noun	Φοῖνιξ
new\s	noun	ναῦς/νεώς/ναός
ko/rumb'	noun	κορύμβη/κόρυμβος
,	SENT	,
e)p'	preposition	ἐπί/ἐπι
a)/llhn	adjective	ἄλλος
d'	particle	οὐδέ/δέ/??
a)/llos	adjective	ἄλλος
hu)/qunen	verb	εὐθύνω
do/ru	noun	δόρυ
.	SENT	.
ta\	article	ὁ/τίς
prw=ta	adjective	πρότερος/πρῶτος
me/n	adverb	μέν
nun	adverb	νῦν#1/νῦν/νυν#2
r(eu=ma	noun	ῥεῦμα
*persikou=	adjective	Περσικός/περσικός
stratou=	noun	στρατός
a)ntei=xen	verb	ἀντέχω
:	SENT	:
w(s	adverb	ὡς#2/ʽὡς/ὥς/ὡς
de\	particle	μηδέ/δέ/οὐδέ
plh=qos	noun	πλῆθος
e)n	preposition	ἐν/εἰς
stenw=|	adjective	στενός
new=n	noun	ναῦς/νεώς/ναός/νέα
h)/qroist'	verb	ἀθροίζω
a)rwgh\	noun	ἀρωγή
d'	particle	οὐδέ/δέ/??
ou)/tis	adjective	οὔτις
a)llh/lois	pronoun	ἀλλήλων
parh=n	verb	πάρειμι/πάρειμι#1
,	SENT	,
au)toi\	pronoun	αὐτός
d'	particle	οὐδέ/δέ/??
u(f'	preposition	ὑπό
au(tw=n	pronoun	αὐτός/ἑαυτοῦ
e)mbo/lois	noun	ἔμβολον/ἔμβολος
xalkosto/mois	adjective	χαλκόστομος
pai/ont'	verb	παίω
,	SENT	,
e)/qrauon	verb	θραύω
pa/nta	pronoun	πᾶς
kwph/rh	adjective	κωπήρης
sto/lon	noun	στόλος
,	SENT	,
*(ellhnikai/	adjective	Ἑλληνικός
te	particle	τε/??/οὔτε
nh=es	noun	ναῦς
ou)k	adverb	οὐ
a)frasmo/nws	adverb	ἀφράσμων/ἀφράδμων
ku/klw|	adverb	κύκλῳ
pe/ric	adverb	πέριξ
e)/qeinon	verb	θείνω
,	SENT	,
u(ptiou=to	verb	ὑπτιόω/ὑπτιόομαι
de\	particle	μηδέ/δέ/οὐδέ
ska/fh	noun	σκάφη/σκάφος
new=n	noun	ναῦς/νεώς/ναός/νέα
,	SENT	,
qa/lassa	noun	θάλασσα
d'	particle	οὐδέ/δέ/??
ou)ke/t'	adverb	οὐκέτι
h)=n	verb	είμί/εἰμί#1/εἰμί/ἠμί
i)dei=n	verb	ἰδέω/εἶδον/ὁράω
,	SENT	,
nauagi/wn	noun	ναυάγιον
plh/qousa	verb	πλήθω
kai\	conjunction	???/καί
fo/nou	noun	φόνος
brotw=n	noun	βροτός
.	SENT	.
a)ktai\	noun	ἀκτή
de\	particle	μηδέ/δέ/οὐδέ
nekrw=n	adjective	νεκρός
xoira/des	noun	χοιράς
t'	particle	τε
e)plh/quon	verb	πληθύω
,	SENT	,
fugh=|	noun	φυγή
d'	particle	οὐδέ/δέ/??
a)ko/smw|	adjective	ἄκοσμος
pa=sa	adjective	πᾶς
nau=s	noun	ναῦς
h)re/sseto	verb	ἐρέσσω
,	SENT	,
o(/saiper	adjective	ὅσος
h)=san	verb	εἰμί#1/εἰμί
barba/rou	adjective	βάρβαρος
strateu/matos	noun	στράτευμα
.	SENT	.
toi\	pronoun	ὁ//σύ/ὅς
d'	particle	οὐδέ/δέ/??
w(/ste	conjunction	ὥστε
qu/nnous	noun	θύννος
h)/	conjunction	ἤ/ἠέ
tin'	pronoun	τις
i)xqu/wn	noun	ἰχθύς
bo/lon	noun	βόλος
a)gai=si	noun	ἀγή
kwpw=n	verb	κωπέω/κωπάω
qrau/masi/n	noun	θραῦμα
t'	particle	τε
e)reipi/wn	noun	ἐρείπιον
e)/paion	verb	παίω
,	SENT	,
e)rra/xizon	verb	ῥαχίζω
:	SENT	:
oi)mwgh\	noun	οἰμωγή
d'	particle	οὐδέ/δέ/??
o(mou=	adverb	ὁμοῦ
kwku/masin	noun	κώκυμα
katei=xe	verb	κατέχω
pelagi/an	adjective	πελάγιος
a(/la	noun	ἅλας/ἅλς
,	SENT	,
e(/ws	conjunction	ἑώς/ἕως/ἔως
kelainh=s	adjective	κελαινός
nukto\s	noun	νύξ
o)/mm'	noun	ὄμμα
a)fei/leto	verb	ἀφαιρέω
.	SENT	.
kakw=n	adjective	κακός
de\	particle	μηδέ/δέ/οὐδέ
plh=qos	noun	πλῆθος
,	SENT	,
ou)	adverb	οὐκ/οὔπως/οὐ
d'	particle	οὐδέ/δέ/??
a)\n	particle	ἄν
ei)	conjunction	εἰ
de/k'	adjective	δέκα
h)/mata	noun	ἦμαρ
stoixhgoroi/hn	verb	στοιχηγορέω
,	SENT	,
ou)k	adverb	οὐ
a)\n	particle	ἄν
e)kplh/saimi/	verb	ἐκπίμπλημι
soi	pronoun	σοι/σύ
.	SENT	.
eu)=	adverb	εὖ
ga\r	particle	γάρ
to/d'	pronoun	ὅδε
i)/sqi	verb	εἰμί#1/εἰμί/οἶδα
,	SENT	,
mhda/m'	adjective	μηδαμός
h(me/ra|	noun	ἡμέρα
mia=|	adjective	εἷς
plh=qos	noun	πλῆθος
tosouta/riqmon	adjective	τοσουτάριθμος
a)nqrw/pwn	noun	ἄνθρωπος
qanei=n	verb	θνήσκω
.	SENT	.
ai)ai=	interjection	αἰαῖ
,	SENT	,
kakw=n	adjective	κακός
dh\	particle	δή
pe/lagos	noun	πέλαγος
e)/rrwgen	verb	ῥήγνυμι
me/ga	adjective	μέγας
*pe/rsais	noun	Πέρσης/πέρσης
te	conjunction	τε/ὅτε
kai\	conjunction	???/καί
pro/panti	adjective	πρόπας
barba/rwn	noun	βάρβαρος
ge/nei	noun	γένος
.	SENT	.
eu)=	adverb	εὖ
nun	adverb	νῦν#1/νῦν/νυν#2
to/d'	pronoun	ὅδε
i)/sqi	verb	εἰμί#1/εἰμί/οἶδα
,	SENT	,
mhde/pw	adverb	μηδέπω
mesou=n	verb	μεσόω
kako/n	adjective	κακός
:	SENT	:
toia/d'	pronoun	τοιόσδε
e)p'	preposition	ἐπί/ἐπι
au)toi=s	pronoun	αὐτός
h)=lqe	verb	ἔρχομαι
sumfora\	noun	συμφορά
pa/qous	noun	πάθος
w(s	conjunction	ὥς/ὡς
toi=sde	pronoun	ὅδε
kai\	conjunction	???/καί
di\s	adverb	δίς
a)ntishkw=sai	verb	ἀντισηκόω
r(oph=|	noun	ῥοπή
.	SENT	.
kai\	conjunction	???/καί
ti/s	pronoun	τις/τίς/τὶς
ge/noit'	verb	γίγνομαι
a)\n	adverb	ἀν/ἄν/ἐάν
th=sd'	pronoun	ὅδε
e)/t'	adverb	ἔτι
e)xqi/wn	adjective	ἐχθίων
tu/xh	noun	τύχη
;	SENT	;
le/con	verb	λέγω
ti/n'	pronoun	τις/τίς
au)=	adverb	αὖ/αὗ
fh\s	verb	φημί
th/nde	pronoun	ὅδε
sumfora\n	noun	συμφορά
stratw=|	noun	στρατός
e)lqei=n	verb	ἔρχομαι
kakw=n	adjective	κακός
r(e/pousan	verb	ῥέπω
e)s	preposition	εἰς
ta\	article	ὁ/τίς
ma/ssona	noun	μάσσων
.	SENT	.
*persw=n	noun	Πέρσης/Ρέρσης/πέρσης
o(/soiper	adjective	ὅσος
h)=san	verb	εἰμί#1/εἰμί
a)kmai=oi	adjective	ἀκμαῖος
fu/sin	noun	φύσις
,	SENT	,
yuxh/n	noun	ψυχή
t'	particle	τε
a)/ristoi	adjective	ἄριστος/ἀγαθός
keu)ge/neian	noun	εὐγένεια
e)kprepei=s	adjective	ἐκπρεπής
,	SENT	,
au)tw=|	pronoun	αὐτός
t'	particle	τε
a)/nakti	noun	ἄναξ
pi/stin	noun	πίστις
e)n	preposition	ἐν/εἰς
prw/tois	adjective	πρότερος/πρῶτος
a)ei/	adverb	ἀεί
,	SENT	,
teqna=sin	verb	θνήσκω
ai)sxrw=s	adverb	αἰσχρός/αἰσχρῶς
duskleesta/tw|	adjective	δυσκλεής
mo/rw|	noun	μόρον/μόρος
.	SENT	.
oi)\	interjection	ὄι/οἰ/οἴ
'	unknown	unknown
gw\	pronoun	ἐγώ
ta/laina	adjective	τάλας
sumfora=s	noun	συμφορεύς/συμφορά
kakh=s	adjective	κακός
,	SENT	,
fi/loi	adjective	φίλος
.	SENT	.
poi/w|	pronoun	ποῖος
mo/rw|	noun	μόρον/μόρος
de\	adverb	δέ/οὐ
tou/sde	pronoun	ὅδε
fh\s	verb	φημί
o)lwle/nai	verb	ὄλλυμι
;	SENT	;
nh=so/s	noun	νῆσος
tis	pronoun	τις/τίς/τὶς
e)/sti	verb	εἰμί#1/εἰμί
pro/sqe	preposition	πρόσθεν
*salami=nos	noun	Σαλαμίς/σαλαμίς
to/pwn	noun	τόπος
,	SENT	,
baia/	adjective	βαιός
,	SENT	,
du/sormos	adjective	δύσορμος
nausi/n	noun	ναῦς
,	SENT	,
h(\n	pronoun	ὅς
o(	article	ὁ
filo/xoros	adjective	φιλόχορος
*pa\n	noun	Πάν
e)mbateu/ei	verb	ἐμβατεύω
,	SENT	,
ponti/as	adjective	πόντιος
a)kth=s	noun	ἀκτή/ἀκτέα
e)/pi	verb	ἐπί/ἔπειμι
.	SENT	.
e)ntau=qa	adverb	ἐνταῦθα
pe/mpei	verb	πέμπω
tou/sd'	pronoun	ὅδε
,	SENT	,
o(/pws	conjunction	ὅπως
,	SENT	,
o(/tan	adverb	ὅταν
new=n	noun	ναῦς/νεώς/ναός/νέα
fqare/ntes	verb	φθείρω
e)xqroi\	adjective	ἐχθρός
nh=son	noun	νῆσος
e)ksw|zoi/ato	verb	ἐκσῴζω
,	SENT	,
ktei/noien	verb	κτείνω
eu)xei/rwton	adjective	εὐχείρωτος
*(ellh/nwn	noun	Ἕλλην/῞ἕλλην
strato/n	noun	στρατός
,	SENT	,
fi/lous	adjective	φίλος
d'	particle	οὐδέ/δέ/??
u(peksw/|zoien	verb	ὑπεκσῴζω
e)nali/wn	adjective	ἐνάλιος
po/rwn	noun	πόρος
,	SENT	,
kakw=s	adverb	κακῶς/κακός
to\	article	ὁ
me/llon	verb	μέλλω
i(storw=n	verb	ἱστορέω
.	SENT	.
w(s	adverb	ὡς#2/ʽὡς/ὥς/ὡς
ga\r	particle	γάρ
qeo\s	noun	θεός
naw=n	noun	ναῦς/ναός
e)/dwke	verb	δίδωμι
ku=dos	noun	κῦδος
*(/ellhsin	noun	Ἕλλην/῞ἕλλην
ma/xhs	noun	μαχή/μάχη
,	SENT	,
au)qhmero\n	adverb	αὐθήμερος
fra/cantes	verb	φράζω/φράσσω
eu)xa/lkois	adjective	εὔχαλκος
de/mas	noun	δέμας
o(/ploisi	noun	ὅπλον
naw=n	noun	ναῦς/ναός
e)ce/qrw|skon	verb	ἐκθρῴσκω
:	SENT	:
a)mfi\	preposition	ἀμφί
de\	particle	μηδέ/δέ/οὐδέ
kuklou=nto	verb	κυκλόω/κυκλέω
pa=san	pronoun	πᾶς
nh=son	noun	νῆσος
,	SENT	,
w(/st'	conjunction	ὥστε
a)mhxanei=n	verb	ἀμηχανάω/ἀμηχανέω
o(/poi	adverb	ὅποι
tra/pointo	verb	τρέπω
.	SENT	.
polla\	adjective	πολύς
me\n	particle	μέν
ga\r	particle	γάρ
e)k	preposition	ἐκ
xerw=n	noun	χείρ
pe/troisin	noun	πέτρος
h)ra/ssonto	verb	ἀράσσω
,	SENT	,
tocikh=s	adjective	τοξικός
t'	particle	τε
a)/po	preposition	ἀπό
qw/miggos	noun	θῶμιγξ
i)oi\	noun	ἰός
prospi/tnonte/s	verb	προσπίπτω
w)/llusan	verb	ὄλλυμι
:	SENT	:
te/los	noun	τέλος
d'	particle	οὐδέ/δέ/??
e)formhqe/ntes	verb	ἐφορμάω/ἐφορμέω
e)c	preposition	ἐκ
e(no\s	adjective	εἷς/εἵς
r(o/qou	noun	ῥόθος
pai/ousi	verb	παίω
,	SENT	,
kreokopou=si	verb	κρεοκοπέω
dusth/nwn	adjective	δύστηνος
me/lh	noun	μέλη/μέλος
,	SENT	,
e(/ws	conjunction	ἑώς/ἕως/ἔως
a(pa/ntwn	adjective	ἅπας
e)cape/fqeiran	verb	ἐξαποφθείρω
bi/on	noun	βίος
.	SENT	.
*ce/rchs	noun	Ξέρξης/Ξήρξης
d'	particle	οὐδέ/δέ/??
a)nw/|mwcen	verb	ἀνοιμώζω
kakw=n	adjective	κακός
o(rw=n	verb	ὁράω
ba/qos	noun	βάθος
:	SENT	:
e(/dran	noun	ἕδρα
ga\r	particle	γάρ
ei)=xe	verb	ἔχω
panto\s	pronoun	πᾶς
eu)agh=	adjective	εὐαγής
stratou=	noun	στρατός
,	SENT	,
u(yhlo\n	adjective	ὑψηλός
o)/xqon	noun	ὄχθος
a)/gxi	preposition	ἄγχι
pelagi/as	adjective	πελάγιος
a(lo/s	noun	ἅλς
:	SENT	:
r(h/cas	verb	ῥήγνυμι/ῥήσσω
de\	particle	μηδέ/δέ/οὐδέ
pe/plous	noun	πεπλος/πέπλος
ka)nakwku/sas	verb	ἀνακωκύω
ligu/	adjective	λιγύς
,	SENT	,
pezw=|	adjective	πεζός
paraggei/las	verb	παραγγέλλω
a)/far	adverb	ἄφαρ
strateu/mati	noun	στράτευμα
,	SENT	,
i(/hs'	verb	ἱέω/ἵημι
a)ko/smw|	adjective	ἄκοσμος
cu\n	preposition	σύν
fugh=|	noun	φυγή
.	SENT	.
toia/nde	pronoun	τοιόσδε
soi	pronoun	σοι/σύ
pro\s	preposition	πρός
th=|	article	ὁ/τῇ
pa/roiqe	adverb	πάροιθε
sumfora\n	noun	συμφορά
pa/ra	verb	πάρειμι/πάρα
ste/nein	verb	στένω
.	SENT	.
w)=	interjection	ὦ
stugne\	adjective	στυγνός
dai=mon	noun	δαίμων
,	SENT	,
w(s	adverb	ὡς#2/ʽὡς/ὥς/ὡς
a)/r'	particle	ἄρα
e)/yeusas	verb	ψεύδω
frenw=n	noun	φρήν
*pe/rsas	noun	Πέρσης
:	SENT	:
pikra\n	adjective	πικρός
de\	particle	μηδέ/δέ/οὐδέ
pai=s	noun	παῖς
e)mo\s	adjective	ἐμός
timwri/an	noun	τιμωρία
kleinw=n	adjective	κλεινός
*)aqhnw=n	noun	̓ἀθῆναι/Ἀθῆναι
hu(=re	verb	εὑρίσκω
,	SENT	,
kou)k	adverb	οὐ
a)ph/rkesan	verb	ἀπαρκέω/ἀπαίρω
ou(\s	pronoun	ὁ/ὅς
pro/sqe	adverb	πρόσθεν
*maraqw\n	proper	Μαραθών
barba/rwn	noun	βάρβαρος
a)pw/lesen	verb	ἀπόλλυμι
:	SENT	:
w(=n	pronoun	ὅς
a)nti/poina	noun	ἀντίποινα
pai=s	noun	παῖς
e)mo\s	adjective	ἐμός
pra/cein	verb	πράσσω
dokw=n	verb	δοκόω/δοκάζω/δοκέω
toso/nde	pronoun	τοσόσδε
plh=qos	noun	πλῆθος
phma/twn	noun	πῆμα
e)pe/spasen	verb	ἐπισπάω
.	SENT	.
su\	pronoun	σύ
d'	particle	οὐδέ/δέ/??
ei)pe/	verb	λέγω/εἶπον
,	SENT	,
naw=n	noun	ναῦς/ναός
ai(\	pronoun	ὁ/ὅς
pefeu/gasin	verb	φεύγω
mo/ron	noun	μόρον/μόρος
,	SENT	,
pou=	adverb	ποῦ/πού
ta/sd'	pronoun	ὅδε
e)/leipes	verb	λείπω
:	SENT	:
oi)=sqa	verb	εἴδω/οἶδα
shmh=nai	verb	σημαίνω
torw=s	adverb	τορός
;	SENT	;
naw=n	noun	ναῦς/ναός
ge	particle	γε
tagoi\	noun	ταγός
tw=n	article	ὁ/ὅς
leleimme/nwn	verb	λείπω
su/dhn	adverb	σύδην
kat'	preposition	κατα/κατά
ou)=ron	noun	ὅρος/ὅρος#2/οὖρος/οὖρον
ou)k	adverb	οὐ
eu)/kosmon	adjective	εὔκοσμος
ai)/rontai	verb	αἴρω
fugh/n	noun	φυγή
:	SENT	:
strato\s	noun	στρατός
d'	particle	οὐδέ/δέ/??
o(	article	ὁ
loipo\s	adjective	λοιπός
e)/n	preposition	ἐν/εἰς/ἔν
te	particle	τε/??/οὔτε
*boiwtw=n	noun	βοιωτός/Βοιωτός
xqoni\	noun	χθών
diw/lluq'	verb	διόλλυμι
,	SENT	,
oi(	pronoun	/οὗ/ὅς/ἕ/ὁ
me\n	particle	μέν
a)mfi\	preposition	ἀμφί
krhnai=on	adjective	κρηναῖος
ga/nos	noun	γάνος
di/yh|	noun	δίψα
ponou=ntes	verb	πονέω
,	SENT	,
oi(	pronoun	/οὗ/ὅς/ἕ/ὁ
d'	particle	οὐδέ/δέ/??
u(p'	preposition	ὑπο/ὑπό
a)/sqmatos	noun	ἆσθμα/ἄσθμα
kenoi\	adjective	κενός
diekperw=men	verb	διεκπεράω
e)/s	preposition	εἰς
te	particle	τε/??/οὔτε
*fwke/wn	noun	Φωκεύς/Φωκαιεύς/φώκη/φωκεύς
xqo/na	noun	χθών
kai\	conjunction	???/καί
*dwri/d'	noun	δωρίς
ai)=an	noun	αἶα
,	SENT	,
*mhlia=	noun	μηλιεύς
te	particle	τε/??/οὔτε
ko/lpon	noun	κόλπος
,	SENT	,
ou(=	pronoun	ὁς/ὅς/ἕ
*sperxeio\s	noun	Σπερχειός
a)/rdei	verb	ἄρδω
pedi/on	noun	πεδίον
eu)menei=	adjective	εὐμενής
potw=|	adjective	ποτός
:	SENT	:
ka)nteu=qen	adverb	ἐντεῦθεν
h(ma=s	pronoun	ἐγώ/ἡμεῖς
gh=s	noun	Γαῖα/γῆ
*)axaii/dos	noun	Ἀχαιίς
pe/don	noun	πέδον
kai\	conjunction	???/καί
*qessalw=n	noun	Θεσσαλός
po/leis	noun	πολίς/πόλις/πόόλις
u(pespanisme/nous	verb	ὑποσπανίζομαι
bora=s	noun	βορά
e)de/cant'	verb	δέχομαι/δείκνυμι
:	SENT	:
e)/nqa	adverb	ἔνθα
dh\	particle	δή
plei=stoi	adjective	πλεῖστος/πολύς
'	unknown	unknown
qa/non	verb	θνήσκω
di/yh|	noun	δίψα
te	particle	τε/??/οὔτε
limw=|	noun	λιμός
t'	particle	τε
:	SENT	:
a)mfo/tera	adjective	ἀμφότερος/ἀμφότεροι
ga\r	particle	γάρ
h)=n	verb	είμί/εἰμί#1/εἰμί/ἠμί
ta/de	pronoun	ὅδε
.	SENT	.
*magnhtikh\n	adjective	Μαγνητικός
de\	particle	μηδέ/δέ/οὐδέ
gai=an	noun	γαῖα
e)/s	preposition	εἰς
te	particle	τε/??/οὔτε
*makedo/nwn	noun	Μακεδών
xw/ran	noun	χώρα
a)fiko/mesq'	verb	ἀφικνέομαι
,	SENT	,
e)p'	preposition	ἐπί/ἐπι
*)aci/ou	adjective	ἄξιος
po/ron	noun	πόρος
,	SENT	,
*bo/lbhs	noun	Βόλβη
q'	particle	τε
e(/leion	adjective	ἕλειος
do/naka	noun	δόναξ
,	SENT	,
*pa/ggaio/n	noun	Πάγγαιον
t'	particle	τε
o)/ros	noun	ὄρος/ὄρος#1
,	SENT	,
*)hdwni/d'	adjective	Ἠδωνίς
ai)=an	noun	αἶα
:	SENT	:
nukti\	noun	νύξ
d'	particle	οὐδέ/δέ/??
e)n	preposition	ἐν/εἰς
tau/th|	adjective	οὗτος/αὐτός
qeo\s	noun	θεός
xeimw=n'	noun	χειμών
a)/wron	adjective	ἄωρος
w)=rse	verb	ὄρνυμι
,	SENT	,
ph/gnusin	noun	πήγνυσις
de\	particle	μηδέ/δέ/οὐδέ
pa=n	adjective	πᾶς
r(e/eqron	noun	ῥεῖθρον
a(gnou=	adjective	ἁγνός
*strumo/nos	noun	Στρυμών
.	SENT	.
qeou\s	noun	θεός
de/	particle	δέ/οὐδέ
tis	pronoun	τις/τίς/τὶς
to\	article	ὁ
pri\n	adverb	πρίν
nomi/zwn	verb	νομίζω
ou)damou=	adverb	οὐδαμός/οὐδαμοῦ
to/t'	adverb	τότε
hu)/xeto	verb	εὔχομαι
litai=si	noun	λιτή
,	SENT	,
gai=an	noun	γαῖα
ou)rano/n	noun	οὐρανός
te	conjunction	τε/ὅτε
proskunw=n	verb	προσκυνέω
.	SENT	.
e)pei\	conjunction	ἐπεί
de\	adverb	δέ/οὐ
polla\	adjective	πολύς
qeoklutw=n	verb	θεοκλυτέω
e)pau/sato	verb	παύω/ἐπαύω
strato/s	noun	στρατός
,	SENT	,
pera=|	verb	περάω
krustalloph=ga	noun	κρυσταλλοπήξ
dia\	preposition	διά
po/ron	noun	πόρος
:	SENT	:
xw)/stis	pronoun	ὅστις
me\n	particle	μέν
h(mw=n	pronoun	σύ/ἐγώ/ἡμεῖς
pri\n	adverb	πρίν
skedasqh=nai	verb	σκεδάννυμι
qeou=	noun	θέος/θεός
a)kti=nas	noun	ἀκτίς
w(rmh/qh	verb	ὁρμάω/ὁρμέω
,	SENT	,
seswsme/nos	verb	σώζω
kurei=	verb	κυρέω
.	SENT	.
fle/gwn	verb	φλέγω
ga\r	particle	γάρ
au)gai=s	noun	αὐγή
lampro\s	adjective	λαμπρός
h(li/ou	noun	ἥλιος/ἤλιος
ku/klos	noun	κύκλος
me/son	adjective	μέσος
po/ron	noun	πόρος
dih=ke	verb	διήκω/διίημι
,	SENT	,
qermai/nwn	verb	θερμαίνω
flogi/	noun	φλόξ/φλογίς
.	SENT	.
pi=pton	verb	πίπτω
d'	particle	οὐδέ/δέ/??
e)p'	preposition	ἐπί/ἐπι
a)llh/loisin	adjective	ἀλλήλων
:	SENT	:
hu)tu/xei	verb	εὐτυχέω
de/	particle	δέ/οὐδέ
toi	pronoun	σύ
o(/stis	pronoun	ὅστις
ta/xista	adjective	ταχύς/τάχιστος
pneu=m'	noun	πνεῦμα
a)pe/rrhcen	verb	ἀπορρήγνυμι
bi/ou	noun	βίος/βιός
.	SENT	.
o(/soi	pronoun	ὅσος
de\	particle	μηδέ/δέ/οὐδέ
loipoi\	adjective	λοιπός
ka)/tuxon	verb	τυγχάνω
swthri/as	noun	σωτηρία
,	SENT	,
*qrh/|khn	noun	θρᾴκη
pera/santes	verb	περάω
mo/gis	adverb	μόγις
pollw=|	adjective	πολύς
po/nw|	noun	πόνος
,	SENT	,
h(/kousin	verb	ἥκω
e)kfugo/ntes	verb	ἐκφεύγω
,	SENT	,
ou)	adverb	οὐκ/οὔπως/οὐ
polloi/	adjective	πολύς
tines	pronoun	τις/τίς/τὶς
,	SENT	,
e)f'	preposition	ἐπί
e(stiou=xon	adjective	ἑστιοῦχος
gai=an	noun	γαῖα
:	SENT	:
w(s	conjunction	ὥς/ὡς
ste/nein	verb	στένω
po/lin	noun	πόλις
*persw=n	noun	Πέρσης/Ρέρσης/πέρσης
,	SENT	,
poqou=san	verb	ποθέω
filta/thn	adjective	φίλτατος
h(/bhn	noun	ἥβη
xqono/s	noun	χθών
.	SENT	.
tau=t'	adjective	οὗτος
e)/st'	verb	εἰμί
a)lhqh=	adjective	ἀληθής
:	SENT	:
polla\	adjective	πολύς
d'	particle	οὐδέ/δέ/??
e)klei/pw	verb	ἐκλείπω
le/gwn	verb	λέγω
kakw=n	adjective	κακός
a(\	pronoun	ὁς/ὅς/ὁ
*pe/rsais	noun	Πέρσης/πέρσης
e)gkate/skhyen	verb	ἐγκατασκήπτω
qeo/s	noun	θεός
.	SENT	.
w)=	interjection	ὦ
duspo/nhte	adjective	δυσπόνητος
dai=mon	noun	δαίμων
,	SENT	,
w(s	conjunction	ὥς/ὡς
a)/gan	adverb	ἄγαν
baru\s	adjective	βαρύς
podoi=n	noun	πούς
e)nh/lou	adjective	ἔνηλος
panti\	pronoun	πᾶς
*persikw=|	adjective	Περσικός/περσικός
ge/nei	noun	γένος
.	SENT	.
oi)\	interjection	ὄι/οἰ/οἴ
'	unknown	unknown
gw\	pronoun	ἐγώ
ta/laina	adjective	τάλας
diapepragme/nou	verb	διαπράσσω
stratou=	noun	στρατός
:	SENT	:
w)=	interjection	ὦ
nukto\s	noun	νύξ
o)/yis	noun	ὄψις
e)mfanh\s	adjective	ἐμφανής
e)nupni/wn	adjective	ἐνύπνιος
,	SENT	,
w(s	conjunction	ὥς/ὡς
ka/rta	adverb	κάρτα
moi	pronoun	τις/ἐγώ
safw=s	adverb	σαφής/σαφῶς
e)dh/lwsas	verb	δηλόω
kaka/	adjective	κακός
.	SENT	.
u(mei=s	pronoun	σύ/ὑμεῖς
de\	particle	μηδέ/δέ/οὐδέ
fau/lws	adverb	φαῦλος
au)/t'	adjective	αὐτός
a)/gan	adverb	ἄγαν
e)kri/nate	verb	κρίνω
.	SENT	.
o(/mws	adverb	ὅμως
d'	particle	οὐδέ/δέ/??
,	SENT	,
e)peidh\	conjunction	ἐπειδή/ἐπεί
th=|d'	pronoun	ὅδε
e)ku/rwsen	verb	κυρόω
fa/tis	noun	φάτις
u(mw=n	pronoun	σύ/ὑμεῖς
,	SENT	,
qeoi=s	noun	θεός
me\n	particle	μέν
prw=ton	adjective	πρότερος/πρῶτος
eu)/casqai	verb	εὔχομαι
qe/lw	verb	ἐθέλω
:	SENT	:
e)/peita	adverb	ἔπειτα
*gh=|	noun	γῆ
te	conjunction	τε/ὅτε
kai\	conjunction	???/καί
fqitoi=s	adjective	φθιτός
dwrh/mata	noun	δώρημα
h(/cw	verb	ἥκω
labou=sa	verb	λαμβάνω
pe/lanon	noun	πέλανος
e)c	preposition	ἐκ
oi)/kwn	noun	οἶκος
e)mw=n	adjective	ἐμός
,	SENT	,
-	SENT	-
e)pi/stamai	verb	ἐπίσταμαι/ἐφίστημι
me\n	particle	μέν
w(s	adverb	ὡς#2/ʽὡς/ὥς/ὡς
e)p'	preposition	ἐπί/ἐπι
e)ceirgasme/nois	verb	ἐξεργάζομαι
,	SENT	,
a)ll'	conjunction	/ἀλλά/ἀλλα/ἀλλ̓
e)s	preposition	εἰς
to\	article	ὁ
loipo\n	adjective	λοιπός
ei)/	conjunction	εἰ
ti	pronoun	τις/τίς/τὶς
dh\	adverb	δή
lw=|on	adjective	λωίων
pe/loi	verb	πέλω
.	SENT	.
u(ma=s	pronoun	σύ/ὑμεῖς
de\	particle	μηδέ/δέ/οὐδέ
xrh\	verb	χρή/χρὴ
'	SENT	̓
pi\	preposition	ἐπί
toi=sde	pronoun	ὅδε
toi=s	article	ὁ
pepragme/nois	verb	πράσσω
pistoi=si	noun	πιστόν
pista\	adjective	πιστός
cumfe/rein	verb	συμφέρω
bouleu/mata	noun	βούλευμα
:	SENT	:
kai\	conjunction	???/καί
pai=d'	noun	παῖς/παι~ς
,	SENT	,
e)a/n	conjunction	ἐάν
per	particle	πέρ
deu=r'	adverb	δεῦρο
e)mou=	pronoun	ἐμός/ἐγώ/ἐμώ
pro/sqen	adverb	πρόσθεν
mo/lh|	verb	βλώσκω
,	SENT	,
parhgorei=te	verb	παρηγορέω
,	SENT	,
kai\	conjunction	???/καί
prope/mpet'	verb	προπέμπω
e)s	preposition	εἰς
do/mous	noun	δόμος
,	SENT	,
mh\	adverb	μή/μὴ
kai/	conjunction	καί
ti	pronoun	τις/τίς/τὶς
pro\s	preposition	πρός
kakoi=si	adjective	κακός
prosqh=tai	verb	προστίθημι/προσθέω
kako/n	adjective	κακός
.	SENT	.
w)=	interjection	ὦ
*zeu=	noun	Ζεύς/ζεύς
basileu=	noun	βασιλεύς
,	SENT	,
nu=n	adverb	νῦν#1/νῦν
ga\r	particle	γάρ
*persw=n	noun	Πέρσης/Ρέρσης/πέρσης
tw=n	article	ὁ/ὅς
megalau/xwn	adjective	μεγάλαυχος
kai\	conjunction	???/καί
polua/ndrwn	adjective	πολύανδρος
stratia\n	noun	στρατιά
o)le/sas	verb	ὄλλυμι
a)/stu	noun	ἄστυ
to\	article	ὁ
*sou/swn	proper	Σοῦσος/Σοῦσα
h)d'	conjunction	ἠδέ/ἠδη
*)agbata/nwn	proper	Ἀγβάτανα
pe/nqei	noun	πένθος
dnoferw=|	adjective	δνοφερός
kate/kruyas	verb	κατακρύπτω
:	SENT	:
pollai\	adjective	πολύς
d'	particle	οὐδέ/δέ/??
a)talai=s	adjective	ἀταλός
xersi\	noun	χείρ
kalu/ptras	noun	καλύπτρα/κάλυπτρα
katereiko/menai	verb	κατερείκω
diamudale/ois	adjective	διαμυδαλέος
da/krusi	noun	δάκρυον
ko/lpous	noun	κόλπος
te/ggous'	verb	τέγγω
,	SENT	,
a)/lgous	noun	ἄλγος
mete/xousai	verb	μετέχω
.	SENT	.
ai(	article	ὁ
d'	particle	οὐδέ/δέ/??
a(bro/gooi	adjective	ἁβρόγοος
*persi/des	noun	περσίς/Περσίς
a)ndrw=n	noun	ἀνήρ
poqe/ousai	verb	ποθέω
i)dei=n	verb	ἰδέω/εἶδον/ὁράω
a)rtizugi/an	noun	ἀρτιζυγία
,	SENT	,
le/ktrwn	noun	λέκτρον
eu)na\s	noun	εὐνή
a(broxi/twnas	noun	ἁβροχίτων
,	SENT	,
xlidanh=s	adjective	χλιδανός
h(/bhs	noun	ἥβη
te/ryin	noun	τέρψις
,	SENT	,
a)fei=sai	verb	ἀφίημι
,	SENT	,
penqou=si	verb	πενθέω
go/ois	noun	γόος
a)korestota/tois	adjective	ἀκόρεστος
.	SENT	.
ka)gw\	pronoun	ἐγώ
de\	particle	μηδέ/δέ/οὐδέ
mo/ron	noun	μόρον/μόρος
tw=n	article	ὁ/ὅς
oi)xome/nwn	verb	οἴχομαι
ai)/rw	verb	αἴρω
doki/mws	adverb	δόκιμος
polupenqh=	adjective	πολυπενθής
.	SENT	.
nu=n	adverb	νῦν#1/νῦν
ga\r	particle	γάρ
dh\	particle	δή
pro/pasa	adjective	πρόπας
me\n	adverb	μέν
ste/nei	verb	στένω
gai='	noun	γαῖα
*)asia\s	noun	Ἀσιάς
e)kkenoume/na	verb	ἐκκενόω
.	SENT	.
*ce/rchs	noun	Ξέρξης/Ξήρξης
me\n	particle	μέν
a)/gagen	verb	ἄγω
,	SENT	,
popoi=	interjection	πόποι
,	SENT	,
*ce/rchs	noun	Ξέρξης/Ξήρξης
d'	particle	οὐδέ/δέ/??
a)pw/lesen	verb	ἀπόλλυμι
,	SENT	,
totoi=	interjection	τοτοῖ/ὀτοτοῖ
,	SENT	,
*ce/rchs	noun	Ξέρξης/Ξήρξης
de\	particle	μηδέ/δέ/οὐδέ
pa/nt'	adjective	πα~ς/πᾶς/π͂ας
e)pe/spe	verb	ἐφέπω
dusfro/nws	adverb	δύσφρων/δυσφρόνως
bari/dessi	noun	βᾶρις
ponti/ais	adjective	πόντιος
.	SENT	.
ti/pte	adverb	τίπτε
*darei=os	noun	Δαρεῖος/δαρεῖος
me\n	adverb	μέν
ou(/	unknown	unknown
-	SENT	-
tw	adverb	οὕτω
to/t'	adverb	τότε
a)blabh\s	adjective	ἀβλαβής
e)ph=n	verb	ἔπειμι#1/ἔπειμι
to/carxos	noun	τόξαρχος
polih/tais	noun	πολίτης
,	SENT	,
*sousi/dais	noun	Σουσίς
fi/los	adjective	φίλος
a)/ktwr	noun	ἄκτωρ
;	SENT	;
pezou/s	adjective	πεζός
te	particle	τε/??/οὔτε
ga\r	adverb	γάρ
kai\	conjunction	???/καί
qalassi/ous	adjective	θαλάσσιος
lino/pteroi	adjective	λινόπτερος
kuanw/pides	noun	κυανῶπις
na=es	noun	ναῦς
me\n	adverb	μέν
a)/gagon	verb	ἄγω
,	SENT	,
popoi=	interjection	πόποι
,	SENT	,
na=es	noun	ναῦς
d'	particle	οὐδέ/δέ/??
a)pw/lesan	verb	ἀπόλλυμι
,	SENT	,
totoi=	interjection	τοτοῖ/ὀτοτοῖ
,	SENT	,
na=es	noun	ναῦς
panwle/qroisin	adjective	πανώλεθρος
e)mbolai=s	noun	ἐμβολή
,	SENT	,
ai(/	pronoun	ὁ/ὅς
t'	particle	τε
*)iao/nwn	noun	̓ἰάων/Ἰάονες
xe/res	noun	χείρ
.	SENT	.
tutqa\	adjective	τυτθός
d'	particle	οὐδέ/δέ/??
e)kfugei=n	verb	ἐκφεύγω
a)/nakt'	noun	ἄναξ
au)to\n	pronoun	αὐτός
ei)sakou/omen	verb	εἰσακούω
*qrh/|khs	noun	Θρᾴκη/θρᾴκη
a)\m	preposition	ἀνά
pedih/reis	adjective	πεδιήρης
dusxi/mous	adjective	δύσχιμος
te	particle	τε/??/οὔτε
keleu/qous	noun	κέλευθος
.	SENT	.
toi\	pronoun	ὁ//σύ/ὅς
d'	particle	οὐδέ/δέ/??
a)/ra	particle	ἄρα
prwto/moiroi	adjective	πρωτόμοιρος
,	SENT	,
feu=	interjection	φεῦ
,	SENT	,
leifqe/ntes	verb	λείπω
pro\s	preposition	πρός
a)na/gkas	noun	ἀνάγκη
,	SENT	,
h)e/	conjunction	ἤ/ἠέ
,	SENT	,
a)kta\s	noun	ἀκτή
a)mfi\	preposition	ἀμφί
*kuxrei/as	noun	Κύχρεια
,	SENT	,
o)a=	interjection	ὀᾶ
,	SENT	,
su/rontai	verb	σύρω
:	SENT	:
ste/ne	verb	στένω
kai\	conjunction	???/καί
dakna/	unknown	unknown
-	SENT	-
zou	verb	δακνάζομαι
,	SENT	,
baru\	adjective	βαρύς
d'	particle	οὐδέ/δέ/??
a)mbo/ason	verb	ἀναβοάω
ou)ra/ni'	adjective	οὐράνιος
a)/xh	noun	ἄχος
,	SENT	,
o)a=	interjection	ὀᾶ
:	SENT	:
tei=ne	verb	τείνω
de\	particle	μηδέ/δέ/οὐδέ
dusba/ukton	adjective	δυσβάυκτος
boa=tin	noun	βοητής
ta/lainan	adjective	τάλας
au)da/n	noun	αὐδή
.	SENT	.
gnapto/menoi	verb	κνάπτω
de\	particle	μηδέ/δέ/οὐδέ
di/na|	noun	δίνη
,	SENT	,
feu=	interjection	φεῦ
,	SENT	,
sku/llontai	verb	σκύλλω
pro\s	preposition	πρός
a)nau/dwn	adjective	ἄναυδος
,	SENT	,
h)e/	conjunction	ἤ/ἠέ
,	SENT	,
pai/dwn	noun	παῖς
ta=s	article	ὁ
a)mia/ntou	adjective	ἀμίαντος
,	SENT	,
o)a=	interjection	ὀᾶ
.	SENT	.
penqei=	verb	πενθέω
d'	particle	οὐδέ/δέ/??
a)/ndra	noun	ἀνήρ
do/mos	noun	δόμος
sterh	unknown	unknown
-	SENT	-
qei/s	verb	στερέω/τίθημι
toke/es	noun	τοκεύς
t'	particle	τε
a)/paides	noun	ἄπαις
daimo/ni'	adjective	δαιμόνιος
a)/xh	noun	ἄχος
,	SENT	,
o)a=	interjection	ὀᾶ
,	SENT	,
duro/menoi	verb	ὀδύρομαι
ge/rontes	noun	γέρων
to\	article	ὁ
pa=n	adjective	πᾶς
dh\	adverb	δή
klu/ousin	verb	κλύω
a)/lgos	noun	ἄλγος
.	SENT	.
toi\	pronoun	ὁ//σύ/ὅς
d'	particle	οὐδέ/δέ/??
a)na\	preposition	ἀνά
ga=n	noun	γῆ
*)asi/an	noun	Ἀσία/̓Ασία
dh\n	adverb	δήν
ou)ke/ti	adverb	οὐκέτι
personomou=ntai	verb	περσονομέομαι/Περσονομέομαι
,	SENT	,
ou)	adverb	οὐκ/οὔπως/οὐ
d'	particle	οὐδέ/δέ/??
e)/ti	adverb	ἔτι
dasmoforou=sin	verb	δασμοφορέω
desposu/noisin	adjective	δεσπόσυνος
a)na/gkais	noun	ἀνάγκη
,	SENT	,
ou)	adverb	οὐκ/οὔπως/οὐ
d'	particle	οὐδέ/δέ/??
e)s	preposition	εἰς
ga=n	noun	γῆ
propi/tnontes	verb	προπίπτω/προπίτνω
a(/zontai	verb	ἅζομαι
:	SENT	:
basilei/a	noun	βασιλεία
ga\r	particle	γάρ
dio/lwlen	verb	διόλλυμι
i)sxu/s	noun	ἰσχύς
.	SENT	.
ou)	adverb	οὐκ/οὔπως/οὐ
d'	particle	οὐδέ/δέ/??
e)/ti	adverb	ἔτι
glw=ssa	noun	γλῶσσα
brotoi=sin	noun	βροτός
e)n	preposition	ἐν/εἰς
fulakai=s	noun	φυλακή
:	SENT	:
le/lutai	verb	λύω
ga\r	particle	γάρ
lao\s	noun	λαός
e)leu/qera	adjective	ἐλεύθερος
ba/zein	verb	βάζω
,	SENT	,
w(s	conjunction	ὥς/ὡς
e)lu/qh	verb	λύω
zugo\n	noun	ζυγός/ζυγόν
a)lka=s	verb	ἀλκάζω
.	SENT	.
ai(maxqei=sa	verb	αἱμάσσω
d'	particle	οὐδέ/δέ/??
a)/rouran	noun	ἄρουρα
*ai)/antos	noun	Αἴας/αἴας
periklu/sta	adjective	περίκλυστος
na=sos	noun	νῆσος
e)/xei	verb	ἐχώ/ἔχω/χέω/χάω
ta\	article	ὁ/τίς
*persa=n	noun	Πέρσης/πέρσης
.	SENT	.
fi/loi	adjective	φίλος
,	SENT	,
kakw=n	adjective	κακός
me\n	particle	μέν
o(/stis	pronoun	ὅστις
e)/mpeiros	adjective	ἔμπειρος
kurei=	verb	κυρέω
,	SENT	,
e)pi/statai	verb	ἐπίσταμαι/ἐφίστημι
brotoi=sin	noun	βροτός
w(s	conjunction	ὥς/ὡς
o(/tan	adverb	ὅταν
klu/dwn	noun	κλύδων
kakw=n	adjective	κακός
e)pe/lqh|	verb	ἐπέρχομαι
pa/nta	pronoun	πᾶς
deimai/nein	verb	δειμαίνω
filei=	verb	φιλέω
:	SENT	:
o(/tan	adverb	ὅταν
d'	particle	οὐδέ/δέ/??
o(	article	ὁ
dai/mwn	noun	δαίμων
eu)roh=|	verb	εὐροέω
,	SENT	,
pepoiqe/nai	verb	πείθω
to\n	pronoun	ὁ//ὅς/ὁς
au)to\n	pronoun	αὐτός
ai)ei\	adverb	ἀεί
dai/mon'	noun	δαίμων
ou)riei=n	verb	ὁρίζω/οὐρίζω
tu/xhn	noun	τύχη
.	SENT	.
e)moi\	pronoun	ἐμός/ἐγώ
ga\r	particle	γάρ
h)/dh	adverb	ἠδή/ἤδη/ἦδη
pa/nta	pronoun	πᾶς
me\n	adverb	μέν
fo/bou	noun	φόβος
ple/a	adjective	πλέος/πλέως
e)n	preposition	ἐν/εἰς
o)/mmasin	noun	ὄμμα
ta)ntai=a	adjective	ἀνταῖος
fai/netai	verb	φαίνω
qew=n	noun	θέος/θεεός/θέα/θεά/θεός/θεὸς
,	SENT	,
boa=|	verb	βοάω
d'	particle	οὐδέ/δέ/??
e)n	preposition	ἐν/εἰς
w)si\	noun	οὖς
ke/lados	noun	κέλαδος
ou)	adverb	οὐκ/οὔπως/οὐ
paiw/nios	noun	παιώνιος
:	SENT	:
toi/a	adjective	τοῖος
kakw=n	adjective	κακός
e)/kplhcis	noun	ἔκπληξις
e)kfobei=	verb	ἐκφοβέω
fre/nas	noun	φρήν
.	SENT	.
toiga\r	particle	τοιγάρ
ke/leuqon	noun	κέλευθος
th/nd'	pronoun	ὅδε
a)/neu	preposition	ἄνευ
t'	particle	τε
o)xhma/twn	noun	ὄχημα
xlidh=s	noun	χλιδή
te	conjunction	τε/ὅτε
th=s	article	ὁ
pa/roiqen	adverb	πάροιθεϝ/πάροιθε
e)k	preposition	ἐκ
do/mwn	noun	δόμος
pa/lin	adverb	πάλιν
e)/steila	verb	στέλλω
,	SENT	,
paido\s	noun	παῖς
patri\	noun	πατρίς/πατήρ
preumenei=s	adjective	/πρευμενής
xoa\s	noun	χοή
fe/rous'	verb	φέρω
,	SENT	,
a(/per	pronoun	ὅς/ὅσπερ/ὁσπερ
nekroi=si	noun	νεκρός
meilikth/ria	adjective	μειλικτήριος
,	SENT	,
boo/s	noun	βοῦς
t'	particle	τε
a)f'	preposition	ἐπί/ἀπό
a(gnh=s	adjective	ἁγνός
leuko\n	adjective	λευκός
eu)/poton	adjective	εὔποτος
ga/la	noun	γάλα
,	SENT	,
th=s	article	ὁ
t'	particle	τε
a)nqemourgou=	adjective	ἀνθεμουργός
sta/gma	noun	στάγμα
,	SENT	,
pamfae\s	adjective	παμφαής
me/li	noun	μέλι
,	SENT	,
liba/sin	noun	λιβάς
u(drhlai=s	adjective	ὑδρηλός
parqe/nou	noun	παρθένος
phgh=s	noun	πηγή
me/ta	verb	μέτειμι/μέτα
,	SENT	,
a)kh/rato/n	adjective	ἀκήρατος
te	particle	τε/??/οὔτε
mhtro\s	noun	μήτηρ
a)gri/as	adjective	ἄγριος
a)/po	preposition	ἀπό
poto\n	adjective	ποτός
palaia=s	adjective	παλαιός
a)mpe/lou	noun	ἄμπελος
ga/nos	noun	γάνος
to/de	pronoun	ὅδε
:	SENT	:
th=s	article	ὁ
t'	particle	τε
ai)e\n	adverb	ἀεί
e)n	preposition	ἐν/εἰς
fu/lloisi	noun	φύλλον
qallou/shs	verb	θάλλω
bi/on	noun	βίος
canqh=s	adjective	ξανθός
e)lai/as	noun	ἐλαία
karpo\s	noun	καρπός
eu)w/dhs	adjective	εὐώδης
pa/ra	verb	πάρειμι/πάρα
,	SENT	,
a)/nqh	noun	ἄνθη/ἄνθος
te	particle	τε/??/οὔτε
plekta/	noun	πλεκτή
,	SENT	,
pamfo/rou	adjective	πάμφορος
gai/as	noun	γαῖα
te/kna	noun	τέκνον
,	SENT	,
a)ll'	adverb	ἀλλά
,	SENT	,
w)=	interjection	ὦ
fi/loi	adjective	φίλος
,	SENT	,
xoai=si	noun	χοή
tai=sde	pronoun	ὅδε
nerte/rwn	adjective	νέρτερος
u(/mnous	noun	ὕμνος
e)peufhmei=te	verb	ἐπευφημέω
,	SENT	,
to/n	pronoun	ὁ/ὅς
te	particle	τε/??/οὔτε
dai/mona	noun	δαίμων
*darei=on	proper	Δαρεῖος
a)nakalei=sqe	verb	ἀνακαλέω
,	SENT	,
gapo/tous	adjective	γάποτος
d'	particle	οὐδέ/δέ/??
e)gw\	pronoun	ἐγώ
tima\s	noun	τιμή
prope/myw	verb	προπέμπω
ta/sde	pronoun	ὅδε
nerte/rois	adjective	νέρτερος
qeoi=s	noun	θεός
.	SENT	.
basi/leia	noun	βασίλεια#1/βασίλεια/βασίλειον
gu/nai	noun	γυνή
,	SENT	,
pre/sbos	noun	πρέσβος
*pe/rsais	noun	Πέρσης/πέρσης
,	SENT	,
su/	pronoun	σύ
te	particle	τε/??/οὔτε
pe/mpe	verb	πέμπω
xoa\s	noun	χοή
qala/mous	noun	θάλαμος
u(po\	preposition	ὑπό
gh=s	noun	Γαῖα/γῆ
,	SENT	,
h(mei=s	pronoun	ἐγώ/ἡμεῖς
q'	particle	τε
u(/mnois	noun	ὕμνος
ai)thso/meqa	verb	αἰτέω
fqime/nwn	verb	φθίω
pompou\s	noun	πομπός
eu)/fronas	adjective	εὔφρων
ei)=nai	verb	εἰμί#1/εἰμί
kata\	preposition	κατά
gai/as	noun	γαῖα
.	SENT	.
a)lla/	adverb	ἀλλά
,	SENT	,
xqo/nioi	adjective	χθόνιος
dai/mones	noun	δαίμων
a(gnoi/	adjective	ἁγνός
,	SENT	,
*gh=	noun	Γαῖα/γῆ
te	particle	τε/??/οὔτε
kai\	conjunction	???/καί
*(ermh=	noun	ʽἑρμῆς/Ἑρμῆς
,	SENT	,
basileu=	noun	βασιλεύς
t'	particle	τε
e)ne/rwn	noun	ἔνεροι
,	SENT	,
pe/myat'	verb	πέμπω
e)/nerqen	adverb	ἔνερθε
yuxh\n	noun	ψυχή
e)s	preposition	εἰς
fw=s	noun	φάος/φῶς
:	SENT	:
ei)	conjunction	εἰ
ga/r	particle	γάρ
ti	pronoun	τις/τίς/τὶς
kakw=n	adjective	κακός
a)/kos	noun	ἄκος
oi)=de	verb	εἴδω/οἶδα
ple/on	adjective	πλέος/πλείων/πλέως/πολύς
,	SENT	,
mo/nos	adjective	μόνος
a)\n	particle	ἄν
qnhtw=n	adjective	θνητός
pe/ras	noun	πέρα/πέρας
ei)/poi	verb	λέγω/εἶπον
.	SENT	.
h)=	adverb	ἦ/ἦ#2
r('	particle	ἄρα/ἆρα
a)i/ei	verb	ἀίω
mou	pronoun	ἐγώ
makari/tas	noun	μακαρίτης
i)sodai/mwn	adjective	ἰσοδαίμων
basileu\s	noun	βασιλεύς
ba/rbar'	noun	βαρβάρα
a)safhnh=	adjective	ἀσαφηνής
i(e/ntos	verb	ἵημι
ta\	article	ὁ/τίς
panai/ol'	adjective	παναίολος
ai)	adjective	αἰακτός
-	SENT	-
anh=	adjective	αἰανής
du/sqroa	adjective	δύσθρους/δύσθροος
ba/gmat'	noun	βάγμα
,	SENT	,
h)\	conjunction	ἤ
panta/lan'	adjective	παντάλας
a)/xh	noun	ἄχος
diaboa/sw	verb	διαβοάω
;	SENT	;
ne/rqen	adverb	ἔνερθεν/ἔνερθε
a)=ra	particle	ἆρα
klu/ei	verb	κλύω
mou	pronoun	ἐγώ
;	SENT	;
a)lla\	conjunction	ἀλλά/ἀλλὰ
su/	pronoun	σύ
moi	pronoun	τις/ἐγώ
*ga=	noun	γῆ
te	conjunction	τε/ὅτε
kai\	conjunction	???/καί
a)/lloi	adjective	ἄλλος
xqoni/wn	adjective	χθόνιος
a(gemo/nes	noun	ἡγεμών
dai/mona	noun	δαίμων
megauxh=	adjective	μεγαυχής
i)o/nt'	verb	εἰμί/εἶμι
ai)ne/sat'	verb	αἰνέω
e)k	preposition	ἐκ
do/mwn	noun	δόμος
,	SENT	,
*persa=n	noun	Πέρσης/πέρσης
*sousigenh=	adjective	Σουσιγενής
qeo/n	noun	θεός
:	SENT	:
pe/mpete	verb	πέμπω
d'	particle	οὐδέ/δέ/??
a)/nw	adverb	ἄνω
oi(=on	adjective	οἷος
ou)/pw	adverb	οὔπω
*persi\s	noun	Περσίς
ai)='	noun	αἶα
e)ka/luyen	verb	καλύπτω
.	SENT	.
h)=	adverb	ἦ/ἦ#2
fi/los	adjective	φίλος
a(nh/r	noun	ἀνήρ
,	SENT	,
fi/los	adjective	φίλος
o)/xqos	noun	ὄχθος
:	SENT	:
fi/la	adjective	φίλος
ga\r	particle	γάρ
ke/keuqen	verb	κεύθω
h)/qh	noun	ἦθος
.	SENT	.
*)aidwneu\s	noun	Ἅιδης/Ἀιδωνεύς
d'	particle	οὐδέ/δέ/??
a)napom	unknown	unknown
-	SENT	-
po\s	noun	ἀναπομπός
a)nei/hs	verb	ἀνίημι
,	SENT	,
*)aidwneu/s	noun	Ἅιδης/Ἀιδωνεύς
,	SENT	,
qei=on	adjective	θεῖον/θεῖος
a)na/ktora	noun	ἀνάκτωρ/ἀνάκτορον/ἄναξ
*daria=na	noun	δαρεῖος
.	SENT	.
h)e/	conjunction	ἤ/ἠέ
.	SENT	.
ou)	adverb	οὐκ/οὔπως/οὐ
de\	particle	μηδέ/δέ/οὐδέ
ga\r	particle	γάρ
a)/ndras	noun	ἀνήρ
pot'	particle	ποτέ
a)pw/llu	verb	ἀπόλλυμι
polemofqo/roisin	adjective	πολεμοφθόρος
a)/tais	noun	ἄτη
,	SENT	,
qeomh/stwr	noun	θεομήστωρ
d'	particle	οὐδέ/δέ/??
e)kiklh/	unknown	unknown
-	SENT	-
sketo	verb	κικλήσκω
*pe/rsais	noun	Πέρσης/πέρσης
,	SENT	,
qeomh/stwr	noun	θεομήστωρ
d'	particle	οὐδέ/δέ/??
e)/sken	verb	εἰμί
,	SENT	,
e)pei\	conjunction	ἐπεί
strato\n	noun	στρατός
eu)=	adverb	εὖ
podou/xei	verb	ποδουχέω
.	SENT	.
h)e/	conjunction	ἤ/ἠέ
.	SENT	.
balh/n	noun	βαλλήν
,	SENT	,
a)rxai=os	adjective	ἀρχαῖος
balh/n	noun	βαλλήν
,	SENT	,
i)/qi	verb	εἶμι#2/εἶμι
,	SENT	,
i(kou=	verb	ἱκνέομαι
:	SENT	:
e)/lq'	verb	ἔρχομαι
e)p'	preposition	ἐπί/ἐπι
a)/kron	adjective	ἄκρος
ko/rumbon	noun	κόρυμβος
o)/xqou	noun	ὄχθος
,	SENT	,
kroko/bapton	adjective	κροκόβαπτος
podo\s	noun	πούς
eu)/marin	noun	εὔμαρις
a)ei/rwn	adjective	ἄειρος
,	SENT	,
basilei/ou	adjective	βασίλειος
tia/ras	noun	τιάρα
fa/laron	noun	φάλαρον
pifau/skwn	verb	πιφαύσκω
.	SENT	.
ba/ske	verb	βάσκω
pa/ter	noun	πατηρ/πάτηρ/πατήρ
a)/kake	adjective	ἄκακος
*daria/n	noun	Δαρεῖος
,	SENT	,
oi)=	interjection	οἰ/οἶ
.	SENT	.
o(/pws	conjunction	ὅπως
ai)anh=	adjective	αἰανής
klu/h|s	verb	κλύω
ne/a	noun	ναῦς/νέα
t'	particle	τε
a)/xh	noun	ἄχος
,	SENT	,
de/spota	noun	δεσπότης
despo/tou	noun	δεσπότης
fa/nhqi	verb	φαίνω/φανάω
.	SENT	.
*stugi/a	adjective	Στύγιος
ga/r	particle	γάρ
tis	pronoun	τις/τίς/τὶς
e)p'	preposition	ἐπί/ἐπι
a)xlu\s	noun	ἀχλύς
pepo/tatai	verb	ποτάομαι
:	SENT	:
neolai/a	noun	νεολαία
ga\r	particle	γάρ
h)/dh	adverb	ἠδή/ἤδη/ἦδη
kata\	preposition	κατά
pa=s'	adjective	πᾶσ/πᾶς
o)/lwlen	verb	ὄλλυμι
.	SENT	.
ba/ske	verb	βάσκω
pa/ter	noun	πατηρ/πάτηρ/πατήρ
a)/kake	adjective	ἄκακος
*daria/n	noun	Δαρεῖος
,	SENT	,
oi)=	interjection	οἰ/οἶ
.	SENT	.
ai)ai=	interjection	αἰαῖ
ai)ai=	interjection	αἰαῖ
:	SENT	:
w)=	interjection	ὦ
polu/klaute	adjective	πολύκλαυτος/πολύκλαυστος
fi/loisi	adjective	φίλος
qanw/n	verb	θνήσκω
,	SENT	,
?	SENT	?
ti/	pronoun	τις/τίς/τὶς
ta/de	pronoun	ὅδε
duna/ta	noun	δυνάτης
duna/ta	noun	δυνάτης
peri\	preposition	περί
ta=|	article	ὁ
sa=|	adjective	σός
di/duma	adjective	δίδυμος
[	SENT	[
diago/en	unknown	unknown
]	SENT	]
a(ma/rtia	noun	ἁμάρτιον/ἁμάρτημα
;?	unknown	πυνξτ
pa=sai	adjective	πᾶς
ga=|	noun	ὀργή/γῆ
ta=|d'	pronoun	ὅδε
e)ce/fqintai	verb	ἐκφθίνω
tri/skalmoi	adjective	τρίσκαλμος
na=es	noun	ναῦς
a)/naes	adjective	ἄναυς
a)/naes	adjective	ἄναυς
.	SENT	.
w)=	interjection	ὦ
pista\	adjective	πιστός
pistw=n	adjective	πιστός
h(/like/s	noun	ἧλιξ
q'	particle	τε
h(/bhs	noun	ἥβη
e)mh=s	adjective	ἐμός
*pe/rsai	noun	Πέρσης/πέρσης
geraioi/	adjective	γεραιός
,	SENT	,
ti/na	pronoun	ὁς/τις/τίς
po/lis	noun	πόλις/πόόλις
ponei=	verb	πονέω/πονέομαι
po/non	noun	πόνος
;	SENT	;
ste/nei	verb	στένω
,	SENT	,
ke/koptai	verb	κόπτω
,	SENT	,
kai\	conjunction	???/καί
xara/ssetai	verb	χαράσσω
pe/don	noun	πέδον
.	SENT	.
leu/sswn	verb	λεύσσω
d'	particle	οὐδέ/δέ/??
a)/koitin	noun	ἄκοιτις
th\n	article	ὁ
e)mh\n	adjective	ἐμός
ta/fou	noun	τάφος
pe/las	adverb	πέλας
tarbw=	verb	ταρβέω
,	SENT	,
xoa\s	noun	χοή
de\	particle	μηδέ/δέ/οὐδέ
preumenh\s	adjective	πρευμενής
e)deca/mhn	verb	δέχομαι/δείκνυμι
.	SENT	.
u(mei=s	pronoun	σύ/ὑμεῖς
de\	particle	μηδέ/δέ/οὐδέ
qrhnei=t'	verb	θρηνέω
e)ggu\s	adverb	ἐγγύς
e(stw=tes	verb	ἵστημι
ta/fou	noun	τάφος
kai\	conjunction	???/καί
yuxagwgoi=s	adjective	ψυχαγωγός
o)rqia/zontes	verb	ὀρθιάζω
go/ois	noun	γόος
oi)ktrw=s	adverb	οἰκτρός
kalei=sqe/	verb	καλέω
m'	pronoun	εγω/ἐγώ/ἐγώγε
:	SENT	:
e)sti\	verb	εἰμί#1/εἰμί
d'	particle	οὐδέ/δέ/??
ou)k	adverb	οὐ
eu)e/codon	adjective	εὐέξοδος
,	SENT	,
a)/llws	adverb	ἄλλος/ἄλλως
te	particle	τε/??/οὔτε
pa/ntws	adverb	πάντως
xoi)	article	ὁ
kata\	preposition	κατά
xqono\s	noun	χθών
qeoi\	noun	θεός
labei=n	verb	λαμβάνω
a)mei/nous	adjective	ἀγαθός/ἀμείνων
ei)si\n	verb	εἰμί#1/εἰμί
h)\	conjunction	ἤ
meqie/nai	verb	μεθίημι
.	SENT	.
o(/mws	adverb	ὅμως
d'	particle	οὐδέ/δέ/??
e)kei/nois	pronoun	ἐκεῖνος
e)ndunasteu/sas	verb	ἐνδυναστεύω
e)gw\	pronoun	ἐγώ
h(/kw	verb	ἥκω/ἵημι
.	SENT	.
ta/xune	verb	ταχύνω
d'	particle	οὐδέ/δέ/??
w(s	adverb	ὡς#2/ʽὡς/ὥς/ὡς
a)/memptos	adjective	ἄμεμπτος
w)=	interjection	ὦ
xro/nou	noun	χρόνος
.	SENT	.
ti/	pronoun	τις/τίς/τὶς
e)sti	verb	εἰμί#1/εἰμί
*pe/rsais	noun	Πέρσης/πέρσης
neoxmo\n	adjective	νεοχμός
e)mbriqe\s	adjective	ἐμβριθής
kako/n	adjective	κακός
:	SENT	:
se/bomai	verb	σέβομαι
me\n	particle	μέν
proside/sqai	verb	προσεῖδον
,	SENT	,
se/bomai	verb	σέβομαι
d'	particle	οὐδέ/δέ/??
a)nti/a	adjective	ἀντίος/ἀντίον
le/cai	verb	λέγω
se/qen	pronoun	σύ
a)rxai/w|	adjective	ἀρχαῖος
peri\	preposition	περί
ta/rbei	noun	τάρβος
.	SENT	.
a)ll'	conjunction	/ἀλλά/ἀλλα/ἀλλ̓
e)pei\	conjunction	ἐπεί
ka/twqen	adverb	κάτωθεν
h)=lqon	verb	ἔρχομαι
soi=s	adjective	σός
go/ois	noun	γόος
pepeisme/nos	verb	πείθω
,	SENT	,
mh/	conjunction	μή
ti	pronoun	τις/τίς/τὶς
makisth=ra	noun	μακιστήρ
mu=qon	noun	μῦθος
,	SENT	,
a)lla\	conjunction	ἀλλά/ἀλλὰ
su/ntomon	adjective	σύντομος
le/gwn	verb	λέγω
ei)pe\	verb	λέγω/εἶπον
kai\	conjunction	???/καί
pe/raine	verb	περαίνω
pa/nta	adjective	/πα~ς/πᾶς
,	SENT	,
th\n	article	ὁ
e)mh\n	adjective	ἐμός
ai)dw=	noun	αἰδώς/αἰδώ
meqei/s	verb	μεθίημι
.	SENT	.
di/emai	verb	δίεμαι
me\n	particle	μέν
xari/sasqai	verb	χαρίζω/χαρίζομαι
,	SENT	,
di/emai	verb	δίεμαι
d'	particle	οὐδέ/δέ/??
a)nti/a	adjective	ἀντίος/ἀντίον
fa/sqai	verb	φημί
,	SENT	,
le/cas	verb	λέγω
du/slekta	adjective	δύσλεκτος
fi/loisin	adjective	φίλος
.	SENT	.
a)ll'	conjunction	/ἀλλά/ἀλλα/ἀλλ̓
e)pei\	conjunction	ἐπεί
de/os	noun	δέος
palaio\n	adjective	παλαιός
soi\	pronoun	σύ/σός
frenw=n	noun	φρήν
a)nqi/statai	verb	ἀνθίστημι
,	SENT	,
tw=n	article	ὁ/ὅς
e)mw=n	adjective	ἐμός
le/ktrwn	noun	λέκτρον
geraia\	adjective	γεραιός
cu/nnom'	adjective	σύννομος
eu)gene\s	adjective	εὐγενής
gu/nai	noun	γυνή
,	SENT	,
klauma/twn	noun	κλαῦμα
lh/casa	verb	λήγω
tw=nde	pronoun	ὅδε
kai\	conjunction	???/καί
go/wn	noun	γόος
safe/s	adjective	σαφής
ti/	pronoun	τις/τίς/τὶς
moi	pronoun	τις/ἐγώ
le/con	verb	λέγω
:	SENT	:
a)nqrw/peia	adjective	ἀνθρώπειος
d'	particle	οὐδέ/δέ/??
a)/n	particle	ἄν
toi	particle	τοι
ph/mat'	noun	πῆμα
a)\n	adverb	ἀν/ἄν/ἐάν
tu/xoi	verb	τυγχάνω
brotoi=s	noun	βροτός
.	SENT	.
polla\	adjective	πολύς
me\n	particle	μέν
ga\r	particle	γάρ
e)k	preposition	ἐκ
qala/sshs	noun	θάλασσα
,	SENT	,
polla\	adjective	πολύς
d'	particle	οὐδέ/δέ/??
e)k	preposition	ἐκ
xe/rsou	noun	χέρσος
kaka\	adjective	κακός
gi/gnetai	verb	γίγνομαι
qnhtoi=s	adjective	θνητός
,	SENT	,
o(	article	ὁ
ma/sswn	adjective	μάσσων
bi/otos	noun	βίοτος
h)\n	conjunction	εἄν/ἐάν
taqh=|	verb	τείνω
,	SENT	,
pro/sw	adverb	πρόσω
.	SENT	.
w)=	interjection	ὦ
brotw=n	noun	βροτός
pa/ntwn	adjective	πᾶς
u(persxw\n	verb	ὑπερέχω
o)/lbon	noun	ὄλβος
eu)tuxei=	verb	εὐτυχέω
po/tmw|	noun	πότμος
w(s	conjunction	ὥς/ὡς
e(/ws	conjunction	ἑώς/ἕως/ἔως
t'	particle	τε
e)/leusses	verb	λεύσσω
au)ga\s	noun	αὐγή
h(li/ou	noun	ἥλιος/ἤλιος
zhlwto\s	adjective	ζηλωτός
w)\n	verb	εἰμί#1/εἰμί
bi/oton	noun	βίοτος
eu)ai/wna	noun	εὐαίων
*pe/rsais	noun	Πέρσης/πέρσης
w(s	conjunction	ὥς/ὡς
qeo\s	noun	θεός
dih/gages	verb	διάγω
,	SENT	,
nu=n	adverb	νῦν#1/νῦν
te/	particle	τε
se	pronoun	σύ
zhlw=	verb	ζηλόω/ζηλέω
qano/nta	verb	θνήσκω
,	SENT	,
pri\n	conjunction	πρίν/πρὶν
kakw=n	adjective	κακός
i)dei=n	verb	ἰδέω/εἶδον/ὁράω
ba/qos	noun	βάθος
.	SENT	.
pa/nta	pronoun	πᾶς
ga/r	particle	γάρ
,	SENT	,
*darei='	noun	δαρεῖος
a)kou/sh|	verb	ἀκούω/ἀκέω
mu=qon	noun	μῦθος
e)n	preposition	ἐν/εἰς
braxei=	adjective	βραχύς
xro/nw|	noun	χρόνος
.	SENT	.
diapepo/rqhtai	verb	διαπορθέω
ta\	article	ὁ/τίς
*persw=n	noun	Πέρσης/Ρέρσης/πέρσης
pra/gmaq'	noun	πρᾶγμα
,	SENT	,
w(s	conjunction	ὥς/ὡς
ei)pei=n	verb	λέγω/εἶπον
e)/pos	noun	ἔπος
.	SENT	.
ti/ni	pronoun	τις/τίς/τὶς
tro/pw|	noun	τρόπος
;	SENT	;
loimou=	noun	λοιμός
tis	pronoun	τις/τίς/τὶς
h)=lqe	verb	ἔρχομαι
skhpto\s	noun	σκηπτός
h)\	conjunction	ἤ
sta/sis	noun	στάσις
po/lei	noun	πόλις
;	SENT	;
ou)damw=s	adverb	οὐδαμῶς/οὐδαμός
:	SENT	:
a)ll'	conjunction	/ἀλλά/ἀλλα/ἀλλ̓
a)mf'	preposition	ἀμφί
*)aqh/nas	proper	Ἀθῆναι/Ἀθήνευς/Ἀθήνη
pa=s	pronoun	πᾶς
kate/fqartai	verb	καταφθείρω
strato/s	noun	στρατός
.	SENT	.
ti/s	pronoun	τις/τίς/τὶς
d'	particle	οὐδέ/δέ/??
e)mw=n	adjective	ἐμός
e)kei=se	adverb	ἐκεῖσε
pai/dwn	noun	παῖς
e)strathla/tei	verb	στρατηλατέω/στρατάω
;	SENT	;
fra/son	verb	φράζω
.	SENT	.
qou/rios	adjective	θούριος
*ce/rchs	noun	Ξέρξης/Ξήρξης
,	SENT	,
kenw/sas	verb	κενόω
pa=san	pronoun	πᾶς
h)pei/rou	noun	ἤπειρος/Ἤπειρος
pla/ka	noun	πλάξ
.	SENT	.
pezo\s	adjective	πεζός
h)\	conjunction	ἤ
nau/ths	noun	ναύτης
de\	adverb	δέ/οὐ
pei=ran	noun	πεῖρα
th/nd'	pronoun	ὅδε
e)mw/ranen	verb	μωραίνω
ta/las	adjective	τάλας
;	SENT	;
a)mfo/tera	adjective	ἀμφότερος/ἀμφότεροι
:	SENT	:
diplou=n	adjective	διπλόος
me/twpon	noun	μέτωπον
h)=n	verb	είμί/εἰμί#1/εἰμί/ἠμί
duoi=n	adjective	δύο
strateuma/toin	noun	στράτευμα
.	SENT	.
pw=s	adverb	πως/πῶς
de\	particle	μηδέ/δέ/οὐδέ
kai\	conjunction	???/καί
strato\s	noun	στρατός
toso/sde	adjective	τοσόσδε
pezo\s	adjective	πεζός
h)/nusen	verb	ἀνύω
pera=n	verb	περάω
;	SENT	;
mhxanai=s	noun	μηχανή
e)/zeucen	verb	ζεύγνυμι
*(/ellhs	proper	Ἕλλη
porqmo/n	noun	πορθμός
,	SENT	,
w(/st'	conjunction	ὥστε
e)/xein	verb	ἔχω
po/ron	noun	πόρος
.	SENT	.
kai\	conjunction	???/καί
to/d'	pronoun	ὅδε
e)ce/pracen	verb	ἐκπράσσω
,	SENT	,
w(/ste	conjunction	ὥστε
*bo/sporon	noun	βόσπορος
klh=|sai	verb	κλῄζω/κλείω
me/gan	adjective	μέγας
:	SENT	:
w(=d'	adverb	ὧδε
e)/xei	verb	ἐχώ/ἔχω/χέω/χάω
:	SENT	:
gnw/mhs	noun	γνώμη
de/	particle	δέ/οὐδέ
pou/	adverb	πού
tis	pronoun	τις/τίς/τὶς
daimo/nwn	noun	δαίμων
cunh/yato	verb	συνάπτω
.	SENT	.
feu=	interjection	φεῦ
,	SENT	,
me/gas	adjective	μέγας
tis	pronoun	τις/τίς/τὶς
h)=lqe	verb	ἔρχομαι
dai/mwn	noun	δαίμων
,	SENT	,
w(/ste	conjunction	ὥστε
mh\	adverb	μή/μὴ
fronei=n	verb	φρονέω
kalw=s	adverb	καλῶς/καλός
.	SENT	.
w(s	conjunction	ὥς/ὡς
i)dei=n	verb	ἰδέω/εἶδον/ὁράω
te/los	noun	τέλος
pa/restin	verb	πάρειμι/πάρειμι#1
oi(=on	adjective	οἷος
h)/nusen	verb	ἀνύω
kako/n	adjective	κακός
.	SENT	.
kai\	conjunction	???/καί
ti/	pronoun	τις/τίς/τὶς
dh\	adverb	δή
pra/casin	verb	πράσσω
au)toi=s	pronoun	αὐτός
w(=d'	adverb	ὧδε
e)pistena/zete	verb	ἐπιστενάζω
;	SENT	;
nautiko\s	adjective	ναυτικός
strato\s	noun	στρατός
kakwqei\s	verb	κακόω
pezo\n	adjective	πεζός
w)/lese	verb	ὄλλυμι
strato/n	noun	στρατός
.	SENT	.
w(=de	adverb	ὧδε
pamph/dhn	adverb	παμπήδην
de\	adverb	δέ/οὐ
lao\s	noun	λαός
pa=s	adjective	πᾶς
kate/fqartai	verb	καταφθείρω
dori/	noun	δόρυ/δορίς
;	SENT	;
pro\s	preposition	πρός
ta/d'	pronoun	ὅδε
w(s	adverb	ὡς#2/ʽὡς/ὥς/ὡς
*sou/swn	proper	Σοῦσος/Σοῦσα
me\n	adverb	μέν
a)/stu	noun	ἄστυ
pa=n	adjective	πᾶς
kenandri/an	noun	κενανδρία
ste/nei	verb	στένω
.	SENT	.
w)=	interjection	ὦ
po/poi	interjection	πόποι
kednh=s	adjective	κεδνός
a)rwgh=s	noun	ἀρωγή
ka)pikouri/as	noun	ἐπικουρία
stratou=	noun	στρατός
.	SENT	.
*baktri/wn	adjective	Βάκτριος
d'	particle	οὐδέ/δέ/??
e)/rrei	verb	ῥέω/ἔρρω
panw/lhs	adjective	πανώλης
dh=mos	noun	δῆμος
,	SENT	,
ou)	adverb	οὐκ/οὔπως/οὐ
de/	particle	δέ/οὐδέ
tis	pronoun	τις/τίς/τὶς
ge/rwn	noun	γέρων
.	SENT	.
w)=	interjection	ὦ
me/leos	adjective	μέλεος
,	SENT	,
oi(/an	adjective	οἷος
a)/r'	particle	ἄρα
h(/bhn	noun	ἥβη
cumma/xwn	noun	σύμμαχος
a)pw/lesen	verb	ἀπόλλυμι
.	SENT	.
mona/da	noun	μονάς
de\	particle	μηδέ/δέ/οὐδέ
*ce/rchn	noun	Ξέρξης
e)/rhmo/n	adjective	ἐρῆμος
fasin	verb	φημί
ou)	adverb	οὐκ/οὔπως/οὐ
pollw=n	adjective	πολύς
me/ta	verb	μέτειμι/μέτα
-	SENT	-
pw=s	adverb	πως/πῶς
te	particle	τε/??/οὔτε
dh\	adverb	δή
kai\	conjunction	???/καί
poi=	adverb	ποι/ποῖ
teleuta=n	verb	τελευτάω
;	SENT	;
a)/smenon	adjective	ἄσμενος
molei=n	verb	βλώσκω
ge/furan	noun	γέφυρα
gai=n	noun	γῆ
duoi=n	adjective	δύο
zeukthri/an	adjective	ζευκτήριος
.	SENT	.
kai\	conjunction	???/καί
pro\s	preposition	πρός
h)/peiron	noun	ἤπειρος
sesw=sqai	verb	σώζω
th/nde	pronoun	ὅδε
,	SENT	,
tou=t'	adjective	οὗτος
e)th/tumon	adjective	ἐτήτυμος
;	SENT	;
nai/	interjection	ναί
:	SENT	:
lo/gos	noun	λόγος
kratei=	verb	κρατέω
safhnh\s	adjective	σαφηνής
tou=to/	pronoun	οὗτος
g'	particle	γε
,	SENT	,
ou)	adverb	οὐκ/οὔπως/οὐ
d'	particle	οὐδέ/δέ/??
e)/ni	preposition	ἐν
sta/sis	noun	στάσις
.	SENT	.
feu=	interjection	φεῦ
,	SENT	,
taxei=a/	adjective	ταχύς
g'	particle	γε
h)=lqe	verb	ἔρχομαι
xrhsmw=n	noun	χρησμός
pra=cis	noun	πρᾶξις
,	SENT	,
e)s	preposition	εἰς
de\	particle	μηδέ/δέ/οὐδέ
pai=d'	noun	παῖς/παι~ς
e)mo\n	adjective	ἐμός
*zeu\s	noun	Ζεύς/ζεύς
a)pe/skhyen	verb	ἀποσκήπτω
teleuth\n	noun	τελευτή
qesfa/twn	adjective	θέσφατος
:	SENT	:
e)gw\	pronoun	ἐγώ
de/	particle	δέ/οὐδέ
pou	adverb	ποῦ/πού
dia\	preposition	διά
makrou=	adjective	μακρός
xro/nou	noun	χρόνος
ta/d'	pronoun	ὅδε
hu)/xoun	verb	αὐχέω
e)kteleuth/sein	verb	ἐκτελευτάω
qeou/s	noun	θεός
:	SENT	:
a)ll'	conjunction	/ἀλλά/ἀλλα/ἀλλ̓
o(/tan	adverb	ὅταν
speu/dh|	verb	σπεύδω
tis	pronoun	τις/τίς/τὶς
au)to/s	adjective	αὐτός
,	SENT	,
xw)	article	ὁ
qeo\s	noun	θεός
suna/ptetai	verb	συνάπτω
.	SENT	.
nu=n	adverb	νῦν#1/νῦν
kakw=n	adjective	κακός
e)/oike	verb	ἔοικα
phgh\	noun	πηγή
pa=sin	adjective	πάν/πᾶς
hu(rh=sqai	verb	εὑρίσκω
fi/lois	adjective	φίλος
.	SENT	.
pai=s	noun	παῖς
d'	particle	οὐδέ/δέ/??
e)mo\s	pronoun	ἐμός
ta/d'	pronoun	ὅδε
ou)	adverb	οὐκ/οὔπως/οὐ
kateidw\s	verb	κάτοιδα
h)/nusen	verb	ἀνύω
ne/w|	adjective	νέος
qra/sei	noun	θράσις/θράσος
:	SENT	:
o(/stis	pronoun	ὅστις
*(ellh/sponton	noun	Ἑλλήσποντος
i(ro\n	adjective	ἱερός/ἱρός
dou=lon	noun	δοῦλος
w(\s	adverb	ὥς/ὡς
desmw/masin	noun	δέσμωμα/δεσμωμα
h)/lpise	verb	ἐλπίζω
sxh/sein	verb	ἔχω/σχάω
r(e/onta	verb	ῥέω
,	SENT	,
*bo/sporon	noun	βόσπορος
r(o/on	noun	ῥόον/ῥόος
qeou=	noun	θέος/θεός
:	SENT	:
kai\	conjunction	???/καί
po/ron	noun	πόρος
meterru/qmize	verb	μεταρρυθμίζω
,	SENT	,
kai\	conjunction	???/καί
pe/dais	noun	πέδη
sfurhla/tois	adjective	σφυρήλατος
peribalw\n	verb	περιβάλλω
pollh\n	adjective	πολύς
ke/leuqon	noun	κέλευθος
h)/nusen	verb	ἀνύω
pollw=|	adjective	πολύς
stratw=|	noun	στρατός
,	SENT	,
qnhto\s	adjective	θνητός
w)\n	verb	εἰμί#1/εἰμί
qew=n	noun	θέος/θεεός/θέα/θεά/θεός/θεὸς
te	conjunction	τε/ὅτε
pa/ntwn	pronoun	πᾶς
w)/|et'	verb	οἴομαι
,	SENT	,
ou)k	adverb	οὐ
eu)bouli/a|	noun	εὐβουλία
,	SENT	,
kai\	conjunction	???/καί
*poseidw=nos	noun	Ποσειδῶν/ποσειδῶν
krath/sein	verb	κρατέω
.	SENT	.
pw=s	adverb	πως/πῶς
ta/d'	pronoun	ὅδε
ou)	adverb	οὐκ/οὔπως/οὐ
no/sos	noun	νόσος
frenw=n	noun	φρήν
ei)=xe	verb	ἔχω
pai=d'	noun	παῖς/παι~ς
e)mo/n	adjective	ἐμός
;	SENT	;
de/doika	verb	δείδω
mh\	particle	μή
polu\s	adjective	πολύς
plou/tou	noun	πλοῦτος
po/nos	noun	πόνος
ou(mo\s	adjective	ἐμός/ὑμός
a)nqrw/pois	noun	ἄνθρωπος
ge/nhtai	verb	γίγνομαι
tou=	article	ὁ/ὅς/τὁ/ὀ
fqa/santos	verb	φθάνω/φθάζω
a(rpagh/	noun	ἁρπαγή
.	SENT	.
tau=ta/	pronoun	οὗτος
toi	particle	τοι
kakoi=s	adjective	κακός
o(milw=n	verb	ὁμιλέω
a)ndra/sin	noun	ἀνήρ
dida/sketai	verb	διδάσκω
qou/rios	adjective	θούριος
*ce/rchs	noun	Ξέρξης/Ξήρξης
:	SENT	:
le/gousi	verb	λέγω
d'	particle	οὐδέ/δέ/??
w(s	adverb	ὡς#2/ʽὡς/ὥς/ὡς
su\	pronoun	σύ
me\n	adverb	μέν
me/gan	adjective	μέγας
te/knois	noun	τέκνον
plou=ton	noun	πλοῦτος
e)kth/sw	verb	κτάομαι/κτέομαι
cu\n	preposition	σύν
ai)xmh=|	noun	αἰχμή
,	SENT	,
to\n	article	ὁ/τὸν
d'	particle	οὐδέ/δέ/??
a)nandri/as	noun	ἀνανδρία
u(/po	preposition	ὑπό
e)/ndon	adverb	ἔνδον
ai)xma/zein	verb	αἰχμάζω
,	SENT	,
patrw=|on	adjective	πατρῷος
d'	particle	οὐδέ/δέ/??
o)/lbon	noun	ὄλβος
ou)de\n	adjective	οὐδείς
au)ca/nein	verb	αὐξάνω
.	SENT	.
toia/d'	pronoun	τοιόσδε
e)c	preposition	ἐκ
a)ndrw=n	noun	ἀνήρ
o)nei/dh	noun	ὄνειδος
polla/kis	adverb	πολλάκις
klu/wn	verb	κλύω
kakw=n	adjective	κακός
th/nd'	pronoun	ὅδε
e)bou/leusen	verb	βουλεύω
ke/leuqon	noun	κέλευθος
kai\	conjunction	???/καί
stra/teum'	noun	στράτευμα
e)f'	preposition	ἐπί
*(ella/da	noun	Ἑλλάς/ʽἑλλάς
.	SENT	.
toiga/r	particle	τοιγάρ
sfin	pronoun	σφεῖς
e)/rgon	noun	ἔργον
e)sti\n	verb	εἰμί#1/εἰμί
e)ceirgasme/non	verb	ἐξεργάζομαι
me/giston	adjective	μέγας
,	SENT	,
a)ei/mnhston	adjective	ἀείμνηστος
,	SENT	,
oi(=on	adjective	οἷος
ou)de/pw	adverb	οὐδέπω
to/d'	pronoun	ὅδε
a)/stu	noun	ἄστυ
*sou/swn	proper	Σοῦσος/Σοῦσα
e)cekei/nwsen	verb	ἐκκενόω
peso/n	verb	πίπτω
,	SENT	,
e)c	preposition	ἐκ
ou(=te	pronoun	ὅστε
timh\n	noun	τιμή
*zeu\s	noun	Ζεύς/ζεύς
a)/nac	noun	ἄναξ
th/nd'	pronoun	ὅδε
w)/pasen	verb	ὀπάζω
,	SENT	,
e(/n'	noun	εἷς
a)/ndr'	noun	ἀνήρ
a(pa/shs	adjective	ἅπας
*)asi/dos	adjective	Ἀσίς
mhlotro/fou	adjective	μηλοτρόφος
tagei=n	verb	ταγέω
,	SENT	,
e)/xonta	verb	ἔχω
skh=ptron	noun	σκῆπτρον
eu)qunth/rion	adjective	εὐθυντήριος
.	SENT	.
*mh=dos	noun	Μῆδος
ga\r	particle	γάρ
h)=n	verb	είμί/εἰμί#1/εἰμί/ἠμί
o(	article	ὁ
prw=tos	adjective	πρότερος/πρῶτος
h(gemw\n	noun	ἡγεμών
stratou=	noun	στρατός
:	SENT	:
a)/llos	adjective	ἄλλος
d'	particle	οὐδέ/δέ/??
e)kei/nou	pronoun	ἐκεῖνος/ἐκείνος/εκεῖνος
pai=s	noun	παῖς
to/d'	pronoun	ὅδε
e)/rgon	noun	ἔργον
h)/nusen	verb	ἀνύω
:	SENT	:
fre/nes	noun	φρήν
ga\r	particle	γάρ
au)tou=	pronoun	αὐτοός/αὐτός
qumo\n	noun	θυμός
w)|akostro/foun	verb	οἰακοστροφέω
.	SENT	.
tri/tos	adjective	τρίτος
d'	particle	οὐδέ/δέ/??
a)p'	preposition	ἀπο/ἀπό
au)tou=	pronoun	αὐτοός/αὐτός
*ku=ros	noun	ξψρυς/κῦρος/Κῦρος/Kῦρος
,	SENT	,
eu)dai/mwn	adjective	εὐδαίμων
a)nh/r	noun	ἀνήρ
,	SENT	,
a)/rcas	verb	ἄρχω
e)/qhke	verb	τίθημι
pa=sin	pronoun	πᾶς
ei)rh/nhn	noun	εἰρήνη
fi/lois	adjective	φίλος
:	SENT	:
*ludw=n	noun	Λυδός
de\	particle	μηδέ/δέ/οὐδέ
lao\n	noun	λαός
kai\	conjunction	???/καί
*frugw=n	noun	Φρύξ
e)kth/sato	verb	κτάομαι/κτέομαι
,	SENT	,
*)iwni/an	noun	Ἰωνία
te	particle	τε/??/οὔτε
pa=san	pronoun	πᾶς
h)/lasen	verb	ἐλαύνω
bi/a|	noun	βία
.	SENT	.
qeo\s	noun	θεός
ga\r	particle	γάρ
ou)k	adverb	οὐ
h)/xqhren	verb	ἐχθαίρω
,	SENT	,
w(s	conjunction	ὥς/ὡς
eu)/frwn	adjective	εὔφρων
e)/fu	verb	φύω
.	SENT	.
*ku/rou	noun	Κῦρος/Κύρης
de\	particle	μηδέ/δέ/οὐδέ
pai=s	noun	παῖς
te/tartos	adjective	τέταρτος
hu)/qune	verb	εὐθύνω
strato/n	noun	στρατός
.	SENT	.
pe/mptos	adjective	πέμπτος
de\	particle	μηδέ/δέ/οὐδέ
*ma/rdos	adjective	Μάρδος
h)=rcen	verb	ἔρδω/ἄρχω
,	SENT	,
ai)sxu/nh	noun	αἰσχύνη
pa/tra|	noun	πάτρη/φράτρα/πάτρα
qro/noisi/	noun	θρόνος
t'	particle	τε
a)rxai/oisi	adjective	ἀρχαῖος
:	SENT	:
to\n	article	ὁ/τὸν
de\	adverb	δέ/οὐ
su\n	preposition	σύν
do/lw|	noun	δόλος
*)artafre/nhs	proper	Ἀρταφρένης
e)/kteinen	verb	κτείνω/ἐκτείνω
e)sqlo\s	adjective	ἐσθλός
e)n	preposition	ἐν/εἰς
do/mois	noun	δόμος
,	SENT	,
cu\n	preposition	σύν
a)ndra/sin	noun	ἀνήρ
fi/loisin	adjective	φίλος
,	SENT	,
oi(=s	pronoun	ὁ/ὅς
to/d'	pronoun	ὅδε
h)=n	verb	είμί/εἰμί#1/εἰμί/ἠμί
xre/os	noun	χρέος
.	SENT	.
[e(/ktos	adjective	ἕκτος
de\	particle	μηδέ/δέ/οὐδέ
*ma/rafis	noun	Μάραφις
,	SENT	,
e(/bdomos	adjective	ἕβδομος
d'	particle	οὐδέ/δέ/??
*)artafre/nhs	noun	ἀρταφρένης/Ἀρταφρένης
.]	SENT	.]
ka)gw\	pronoun	ἐγώ
pa/lou	noun	πᾶλος/πάλος
t'	particle	τε
e)/kursa	verb	κυρέω
tou=per	pronoun	τις/τίς/ὅσπερ
h)/qelon	verb	ἐθέλω
,	SENT	,
ka)pestra/teusa	verb	ἐπιστρατεύω
polla\	adjective	πολύς
su\n	preposition	σύν
a)ll'	adverb	ἀλλά
ou)	adverb	οὐκ/οὔπως/οὐ
kako\n	adjective	κακός
toso/nde	pronoun	τοσόσδε
prose/balon	verb	προσβάλλω/προσδαίω
po/lei	noun	πόλις
.	SENT	.
*ce/rchs	noun	Ξέρξης/Ξήρξης
d'	particle	οὐδέ/δέ/??
e)mo\s	adjective	ἐμός
pai=s	noun	παῖς
w)\n	verb	εἰμί#1/εἰμί
ne/os	adjective	νέος
ne/a	noun	ναῦς/νέα
fronei=	verb	φρονέω
,	SENT	,
kou)	adverb	οὐ
mnhmoneu/ei	verb	μνημονεύω
ta\s	article	ὁ
e)ma\s	adjective	ἐμός
e)pistola/s	noun	ἐπιστολή
:	SENT	:
eu)=	adverb	εὖ
ga\r	particle	γάρ
safw=s	adverb	σαφής/σαφῶς
to/d'	pronoun	ὅδε
i)/st'	verb	οἶδα
,	SENT	,
e)moi\	pronoun	ἐμός/ἐγώ
cunh/likes	noun	συνῆλιξ
,	SENT	,
a(/pantes	adjective	ἅπας
h(mei=s	pronoun	ἐγώ/ἡμεῖς
,	SENT	,
oi(\	pronoun	ὁ/ὅς/ἕ
kra/th	noun	κράτος
ta/d'	pronoun	ὅδε
e)/sxomen	verb	ἔχω
,	SENT	,
ou)k	adverb	οὐ
a)\n	particle	ἄν
fanei=men	verb	φαίνω/φανάω
ph/mat'	noun	πῆμα
e)/rcantes	verb	ἔρδω
to/sa	adjective	τόσος
.	SENT	.
ti/	pronoun	τις/τίς/τὶς
ou)=n	particle	οὖν
,	SENT	,
a)/nac	noun	ἄναξ
*darei=e	noun	Δαρεῖος
,	SENT	,
poi=	adverb	ποι/ποῖ
katastre/feis	verb	καταστρέφω
lo/gwn	noun	λογός/λόγος
teleuth/n	noun	τελευτή
;	SENT	;
pw=s	adverb	πως/πῶς
a)\n	particle	ἄν
e)k	preposition	ἐκ
tou/twn	pronoun	οὗτος
e)/ti	adverb	ἔτι
pra/ssoimen	verb	πράσσω
w(s	conjunction	ὥς/ὡς
a)/rista	adjective	ἄριστος/ἀγαθός
*persiko\s	adjective	Περσικός
lew/s	noun	λαός
;	SENT	;
ei)	conjunction	εἰ
mh\	adverb	μή/μὴ
strateu/oisq'	verb	στρατεύω
e)s	preposition	εἰς
to\n	article	ὁ/τὸν
*(ellh/nwn	noun	Ἕλλην/῞ἕλλην
to/pon	noun	τόπος
,	SENT	,
mh	particle	μή/μηδέ
d'	particle	οὐδέ/δέ/??
ei)	conjunction	εἰ
stra/teuma	noun	στράτευμα
plei=on	adjective	πλείων/πλέως/πολύς
to\	article	ὁ
*mhdiko/n	adjective	Μηδικός
.	SENT	.
au)th\	pronoun	οὗτος/αὐτός
ga\r	adverb	γάρ
h(	article	ὁ
gh=	noun	Γαῖα/γῆ
cu/mmaxos	adjective	σύμμαχος
kei/nois	adjective	ἐκεῖνος/κεῖνος
pe/lei	verb	πελάω/πέλω
.	SENT	.
pw=s	adverb	πως/πῶς
tou=t'	adjective	οὗτος
e)/lecas	verb	λέγω
,	SENT	,
ti/ni	pronoun	τις/τίς/τὶς
tro/pw|	noun	τρόπος
de\	adverb	δέ/οὐ
summaxei=	verb	συμμαχέω/συμμάχομαι
;	SENT	;
ktei/nousa	verb	κτείνω
limw=|	noun	λιμός
tou\s	article	ὁ
u(perpo/llous	adjective	ὑπέρπολυς
a)/gan	adverb	ἄγαν
.	SENT	.
a)ll'	conjunction	/ἀλλά/ἀλλα/ἀλλ̓
eu)stalh=	adjective	εὐσταλής
toi	pronoun	σύ
lekto\n	adjective	λεκτός
a)rou=men	verb	αἴρω/ἀρόω/ἀείρω
sto/lon	noun	στόλος
.	SENT	.
a)ll'	conjunction	/ἀλλά/ἀλλα/ἀλλ̓
ou)	adverb	οὐκ/οὔπως/οὐ
d'	adverb	δέ
o(	article	ὁ
mei/nas	verb	μένω
nu=n	adverb	νῦν#1/νῦν
e)n	preposition	ἐν/εἰς
*(ella/dos	noun	Ἑλλάς/ʽἑλλάς
to/pois	noun	τόπος
strato\s	noun	στρατός
kurh/sei	verb	κυρέω
nosti/mou	adjective	νόστιμος
swthri/as	noun	σωτηρία
.	SENT	.
pw=s	adverb	πως/πῶς
ei)=pas	verb	λέγω/εἶπον
;	SENT	;
ou)	adverb	οὐκ/οὔπως/οὐ
ga\r	particle	γάρ
pa=n	adjective	πᾶς
stra/teuma	noun	στράτευμα
barba/rwn	noun	βάρβαρος
pera=|	verb	περάω
to\n	article	ὁ/τὸν
*(/ellhs	proper	Ἕλλη
porqmo\n	noun	πορθμός
*eu)rw/phs	noun	Εὐρώπης/Εὐρώπη/εὐρώπη
a)/po	preposition	ἀπό
;	SENT	;
pau=roi	adjective	παῦρος
ge	particle	γε
pollw=n	adjective	πολύς
,	SENT	,
ei)/	conjunction	εἰ
ti	pronoun	τις/τίς/τὶς
pisteu=sai	verb	πιστόω/πιστεύω
qew=n	noun	θέος/θεεός/θέα/θεά/θεός/θεὸς
xrh\	verb	χρή/χρὴ
qesfa/toisin	adjective	θέσφατος
,	SENT	,
e)s	preposition	εἰς
ta\	article	ὁ/τίς
nu=n	adverb	νῦν#1/νῦν
pepragme/na	verb	πράσσω
ble/yanta	verb	βλέπω
:	SENT	:
sumbai/nei	verb	συμβαίνω
ga\r	particle	γάρ
ou)	adverb	οὐκ/οὔπως/οὐ
ta\	article	ὁ/τίς
me/n	adverb	μέν
,	SENT	,
ta\	article	ὁ/τίς
d'	particle	οὐδέ/δέ/??
ou)/	adverb	οὔπως/οὔτι/οὔτε/οὐ
.	SENT	.
kei)/per	conjunction	εἴπερ
ta/d'	pronoun	ὅδε
e)sti/	verb	εἰμί#1/εἰμί
,	SENT	,
plh=qos	noun	πλῆθος
e)/kkriton	adjective	ἔκκριτος
stratou=	noun	στρατός
lei/pei	verb	λείπω
kenai=sin	adjective	κενός
e)lpi/sin	noun	ἐλπίς
pepeisme/nos	verb	πείθω
.	SENT	.
mi/mnousi	verb	μίμνω
d'	particle	οὐδέ/δέ/??
e)/nqa	adverb	ἔνθα
pedi/on	noun	πεδίον
*)aswpo\s	noun	Ἀσωπός
r(oai=s	noun	ῥοή
a)/rdei	verb	ἄρδω
,	SENT	,
fi/lon	adjective	φίλος
pi/asma	noun	πίασμα
*boiwtw=n	noun	βοιωτός/Βοιωτός
xqoni/	noun	χθών
:	SENT	:
ou(=	pronoun	ὁς/ὅς/ἕ
sfin	pronoun	σφεῖς
kakw=n	adjective	κακός
u(/yist'	adjective	ὕψιστος
e)pamme/nei	verb	ἐπαναμένω/ἐπαμμένω
paqei=n	verb	πάσχω
,	SENT	,
u(/brews	noun	ὕβρις
a)/poina	noun	ἄποινα
ka)qe/wn	adjective	ἄθεος
fronhma/twn	noun	φρόνημα
:	SENT	:
oi(\	pronoun	ὁ/ὅς/ἕ
gh=n	noun	Γαῖα/γῆ
molo/ntes	verb	βλώσκω
*(ella/d'	noun	Ἑλλάς
ou)	adverb	οὐκ/οὔπως/οὐ
qew=n	noun	θέος/θεεός/θέα/θεά/θεός/θεὸς
bre/th	noun	βρέτας/βρέτος
h)|dou=nto	verb	αἰδέομαι
sula=n	noun	σύλη
ou)	adverb	οὐκ/οὔπως/οὐ
de\	adverb	δέ/οὐ
pimpra/nai	verb	πίμπρημι
new/s	noun	ναῦς/νεώς/ναός
:	SENT	:
bwmoi\	noun	βωμός
d'	particle	οὐδέ/δέ/??
a)/istoi	adjective	ἄιστος
,	SENT	,
daimo/nwn	noun	δαίμων
q'	particle	τε
i(dru/mata	noun	ἵδρυμα
pro/rriza	adjective	πρόρριζος
fu/rdhn	adverb	φύρδην
e)cane/straptai	verb	ἐξαναστρέφω
ba/qrwn	noun	βάθρον
.	SENT	.
toiga\r	particle	τοιγάρ
kakw=s	adverb	κακῶς/κακός
dra/santes	verb	δράω
ou)k	adverb	οὐ
e)la/ssona	adjective	ἐλάσσων
pa/sxousi	verb	πάσχω
,	SENT	,
ta\	article	ὁ/τίς
de\	adverb	δέ/οὐ
me/llousi	verb	μέλλω
,	SENT	,
kou)de/pw	adverb	οὐδέπω
kakw=n	adjective	κακός
krhni\s	noun	κρηνίς
a)pe/sbhk'	verb	ἀποσβέννυμι
a)ll'	conjunction	/ἀλλά/ἀλλα/ἀλλ̓
e)/t'	adverb	ἔτι
e)kpidu/etai	verb	ἐκπιδύομαι
.	SENT	.
to/sos	adjective	τόσος
ga\r	particle	γάρ
e)/stai	verb	εἰμί#1/εἰμί
pe/lanos	noun	πέλανος
ai(matosfagh\s	adjective	αἱματοσφαγής
pro\s	preposition	πρός
gh=|	noun	Γαῖα/γῆ
*plataiw=n	noun	Πλάταια
*dwri/dos	noun	Δωρίς/δωρίς
lo/gxhs	noun	λόγχη
u(/po	preposition	ὑπό
:	SENT	:
qi=nes	noun	θίς
nekrw=n	adjective	νεκρός
de\	adverb	δέ/οὐ
kai\	conjunction	???/καί
tritospo/rw|	adjective	τριτόσπορος
gonh=|	noun	γονεύς/γονή
a)/fwna	adjective	ἄφωνος
shmanou=sin	verb	σημαίνω
o)/mmasin	noun	ὄμμα
brotw=n	noun	βροτός
w(s	conjunction	ὥς/ὡς
ou)x	adverb	οὐ
u(pe/rfeu	adverb	ὑπέρφευ
qnhto\n	adjective	θνητός
o)/nta	verb	εἰμί#1/εἰμί/εἴμι
xrh\	verb	χρή/χρὴ
fronei=n	verb	φρονέω
.	SENT	.
u(/bris	noun	ὕβρις
ga\r	particle	γάρ
e)canqou=s'	verb	ἐξανθέω
e)ka/rpwsen	verb	καρπόω
sta/xun	noun	στάχυς
a)/ths	noun	ἄτη
,	SENT	,
o(/qen	adverb	ὅθεν
pa/gklauton	adjective	πάγκλαυστος/πάγκλαυτος
e)cama=|	verb	ἐξαμάω
qe/ros	noun	θέρος
.	SENT	.
toiau=q'	adjective	τοιοῦτος
o(rw=ntes	verb	ὁράω
tw=nde	pronoun	ὅδε
ta)piti/mia	noun	ἐπιτίμιον
me/mnhsq'	verb	μιμνήσκω
*)aqhnw=n	noun	̓ἀθῆναι/Ἀθῆναι
*(ella/dos	noun	Ἑλλάς/ʽἑλλάς
te	particle	τε/??/οὔτε
,	SENT	,
mh	particle	μή/μηδέ
de/	particle	δέ/οὐδέ
tis	pronoun	τις/τίς/τὶς
u(perfronh/sas	verb	ὑπερφρονέω
to\n	article	ὁ/τὸν
paro/nta	verb	πάρειμι
dai/mona	noun	δαίμων
a)/llwn	adjective	ἄλλος
e)rasqei\s	verb	ἔραμαι
o)/lbon	noun	ὄλβος
e)kxe/h|	verb	ἐκχέω
me/gan	adjective	μέγας
.	SENT	.
*zeu/s	noun	Ζεύς/ζεύς
toi	particle	τοι
kolasth\s	noun	κολαστής
tw=n	article	ὁ/ὅς
u(perko/mpwn	adjective	ὑπέρκομπος
a)/gan	adverb	ἄγαν
fronhma/twn	noun	φρόνημα
e)/pestin	verb	ἔπειμι
,	SENT	,
eu)/qunos	noun	εὔθυνος
baru/s	adjective	βαρύς
.	SENT	.
pro\s	preposition	πρός
tau=t'	adjective	οὗτος
e)kei=non	adjective	ἐκεῖνος
,	SENT	,
swfronei=n	verb	σωφρονέω
kexrhme/non	verb	χράω
,	SENT	,
pinu/sket'	verb	πινύσκω
eu)lo/goisi	adjective	εὔλογος
nouqeth/masin	noun	νουθέτημα
,	SENT	,
lh=cai	verb	λήγω
qeoblabou=nq'	verb	θεοβλαβέω
u(perko/mpw|	adjective	ὑπέρκομπος
qra/sei	noun	θράσις/θράσος
.	SENT	.
su\	pronoun	σύ
d'	particle	οὐδέ/δέ/??
,	SENT	,
w)=	interjection	ὦ
geraia\	adjective	γεραιός
mh=ter	noun	μήτηρ
h(	article	ὁ
*ce/rcou	noun	Ξέρξης/ξέρξης
fi/lh	adjective	φίλος
,	SENT	,
e)lqou=s'	verb	ἔρχομαι
e)s	preposition	εἰς
oi)/kous	noun	οἶκος
ko/smon	noun	κόσμος
o(/stis	pronoun	ὅστις
eu)preph\s	adjective	εὐπρεπής
labou=s'	verb	λάπτω/λαμβάνω
u(panti/aze	verb	ὑπαντιάζω
paidi/	noun	παῖς
.	SENT	.
pa/nta	pronoun	πᾶς
ga\r	particle	γάρ
kakw=n	adjective	κακός
u(p'	preposition	ὑπο/ὑπό
a)/lgous	noun	ἄλγος
laki/des	noun	λακίς
a)mfi\	preposition	ἀμφί
sw/mati	noun	σῶμα
sthmorragou=si	verb	στημορραγέω
poiki/lwn	adjective	ποικίλος
e)sqhma/twn	noun	ἔσθημα
.	SENT	.
a)ll'	conjunction	/ἀλλά/ἀλλα/ἀλλ̓
au)to\n	pronoun	αὐτός
eu)fro/nws	adverb	εὐφρόνως
su\	pronoun	σύ
pra/unon	verb	πραύνω
lo/gois	noun	λόγος
:	SENT	:
mo/nhs	adjective	μόνος
ga/r	particle	γάρ
,	SENT	,
oi)=da	verb	εἴδω/οἶδα
,	SENT	,
sou=	pronoun	σύ/σός
klu/wn	verb	κλύω
a)ne/cetai	verb	ἀνέχω
.	SENT	.
e)gw\	pronoun	ἐγώ
d'	particle	οὐδέ/δέ/??
a)/peimi	verb	ἄπειμι/ἄπειμι#1
gh=s	noun	Γαῖα/γῆ
u(po\	preposition	ὑπό
zo/fon	noun	ζόφος
ka/tw	adverb	κάτω
.	SENT	.
u(mei=s	pronoun	σύ/ὑμεῖς
de/	particle	δέ/οὐδέ
,	SENT	,
pre/sbeis	noun	πρέσβυς/πρεσβεύς/πρέσβις
,	SENT	,
xai/ret'	verb	χαίρεω/χαίρω
,	SENT	,
e)n	preposition	ἐν/εἰς
kakoi=s	adjective	κακός
o(/mws	adverb	ὅμως
yuxh=|	noun	ψυχή
dido/ntes	verb	δίδωμι
h(donh\n	noun	ἡδονά/ἡδονή
kaq'	preposition	κατά
h(me/ran	noun	ἡμέρα
,	SENT	,
w(s	conjunction	ὥς/ὡς
toi=s	article	ὁ
qanou=si	verb	θνήσκω
plou=tos	noun	πλοῦτος
ou)de\n	adjective	οὐδείς
w)felei=	verb	ὠφελέω
.	SENT	.
h)=	adverb	ἦ/ἦ#2
polla\	adjective	πολύς
kai\	conjunction	???/καί
paro/nta	verb	πάρειμι
kai\	conjunction	???/καί
me/llont'	verb	μέλλω
e)/ti	adverb	ἔτι
h)/lghs'	verb	ἀλγέω
a)kou/sas	verb	ἀκούω/ἀκέω
barba/roisi	noun	βάρβαρος
ph/mata	noun	πῆμα
.	SENT	.
w)=	interjection	ὦ
dai=mon	noun	δαίμων
,	SENT	,
w(/s	conjunction	ὥς/ὡς
me	pronoun	ἐγώ
po/ll'	adjective	πολύς
e)se/rxetai	verb	εἰσέρχομαι
kaka\	adjective	κακός
a)/lgh	noun	ἄλγος
,	SENT	,
ma/lista	adverb	μάλα/μάλιστα
d'	particle	οὐδέ/δέ/??
h(/de	pronoun	ὅδε
sumfora\	noun	συμφορά
da/knei	verb	δάκνω
,	SENT	,
a)timi/an	noun	ἀτιμία
ge	particle	γε
paido\s	noun	παῖς
a)mfi\	preposition	ἀμφί
sw/mati	noun	σῶμα
e)sqhma/twn	noun	ἔσθημα
klu/ousan	verb	κλύω
,	SENT	,
h(/	pronoun	ὁ/ὅς
nin	pronoun	νιν
a)mpe/xei	verb	ἀμπέχω/ἀμφιχέω
.	SENT	.
a)ll'	conjunction	/ἀλλά/ἀλλα/ἀλλ̓
ei)=mi	verb	εἶμι
,	SENT	,
kai\	conjunction	???/καί
labou=sa	verb	λαμβάνω
ko/smon	noun	κόσμος
e)k	preposition	ἐκ
do/mwn	noun	δόμος
u(pantia/zein	verb	ὑπαντιάζω
paidi/	noun	παῖς
mou	pronoun	ἐγώ
peira/somai	verb	πειράζω/πειράω
.	SENT	.
ou)	adverb	οὐκ/οὔπως/οὐ
ga\r	adverb	γάρ
ta\	article	ὁ/τίς
fi/ltat'	adjective	φίλτατος
e)n	preposition	ἐν/εἰς
kakoi=s	adjective	κακός
prodw/somen	verb	προδίδωμι
.	SENT	.
w)=	interjection	ὦ
po/poi	interjection	πόποι
h)=	adverb	ἦ/ἦ#2
mega/las	adjective	μέγας
a)gaqa=s	adjective	ἀγαθός
te	conjunction	τε/ὅτε
po	preposition	ἀπό
-	SENT	-
lissono/mou	adjective	πολισσονόμος
biota=s	noun	βιοτή
e)peku/rsamen	verb	ἐπικύρω
,	SENT	,
eu)=q'	conjunction	εὖτε
o(	article	ὁ
ghraio\s	adjective	γηραιός
pantarkh\s	adjective	πανταρκής
a)ka/kas	noun	ἀκάκης
a)/maxos	adjective	ἄμαχος
basileu\s	noun	βασιλεύς
i)so/qeos	adjective	ἰσόθεος
*darei=os	proper	Δαρεῖος
a)=rxe	verb	ἄρχω
xw/ras	noun	χώρα
.	SENT	.
prw=ta	adjective	πρότερος/πρῶτος
me\n	particle	μέν
eu)doki/mous	adjective	εὐδόκιμος
stratia\s	noun	στρατιά
a)pe	unknown	unknown
-	SENT	-
faino/meq'	verb	φαίνω/ἀποφαίνω
,	SENT	,
h)de\	conjunction	ἠδέ
nomi/smata	noun	νόμισμα
pu/rgina	adjective	πύργινος
pa/nt'	adjective	πα~ς/πᾶς/π͂ας
e)phu/qune	verb	ἐπευθύνω
,	SENT	,
no/stoi	noun	νόστος
d'	particle	οὐδέ/δέ/??
e)k	preposition	ἐκ
pole/mwn	noun	πόλεμος
a)po/nous	adjective	ἄπονος
a)paqei=s	adjective	ἀπαθής
a)ne/ras	noun	ἀνήρ
eu)=	adverb	εὖ
pra/ssontas	verb	πράσσω
a)=gon	verb	ἄγω
oi)/kous	noun	οἶκος
.	SENT	.
o(/ssas	adjective	ὅσος
d'	particle	οὐδέ/δέ/??
ei(=le	verb	αἱρέω
po/leis	noun	πολίς/πόλις/πόόλις
po/ron	noun	πόρος
ou)	adverb	οὐκ/οὔπως/οὐ
diaba\s	verb	διαβαίνω
*(/aluos	noun	Ἅλυς
potamoi=o	noun	ποταμός
,	SENT	,
ou)	adverb	οὐκ/οὔπως/οὐ
d'	particle	οὐδέ/δέ/??
a)f'	preposition	ἐπί/ἀπό
e(sti/as	noun	ἑστία
suqei/s	verb	σεύω
,	SENT	,
oi(=ai	adjective	οἷος#1/οἷος
*strumoni/ou	adjective	στρυμών
pela/	unknown	unknown
-	SENT	-
gous	noun	πέλαγος
*)axelwi/des	noun	̓ἀχελωίδες
ei)si\	verb	εἰμί#1/εἰμί
pa/roikoi	adjective	πάροικος
*qrh|ki/wn	adjective	Θράκιος
e)pau/lwn	noun	ἔπαυλος
,	SENT	,
li/mnas	noun	λίμνη
t'	particle	τε
e)/ktoqen	adverb	ἔκτοθεν
ai(\	pronoun	ὁ/ὅς
kata\	preposition	κατά
xe/rson	noun	χέρσος
e)lhlame/nai	verb	ἐλαύνω
pe/ri	preposition	περί
pu/rgon	noun	πύργος
tou=d'	pronoun	ὅδε
a)/naktos	noun	ἄναξ
a)/ion	verb	ἀίω
,	SENT	,
*(/ellas	noun	Ἕλλη
t'	particle	τε
a)mfi\	preposition	ἀμφί
po/ron	noun	πόρος
platu\n	adjective	πλατύς
eu)xo/menai	verb	εὔχομαι
,	SENT	,
muxi/a	adjective	μύχιος
te	particle	τε/??/οὔτε
*proponti/s	noun	προποντίς
,	SENT	,
kai\	conjunction	???/καί
sto/mwma	noun	στόμωμα
*po/ntou	noun	Πόντος/πόντος
:	SENT	:
na=soi/	noun	νῆσος
q'	particle	τε
ai(\	pronoun	ὁ/ὅς
kata\	preposition	κατά
prw=n'	noun	πρών
a(/lion	adjective	ἅλιος
peri/klustoi	adjective	περίκλυστος
ta=|de	pronoun	ὅδε
ga=|	noun	ὀργή/γῆ
prosh/menai	verb	προσέω/πρόσημαι/προσῆμαι
oi(/a	adjective	οἷος
*le/sbos	noun	Λέσβος/λέσβος
e)lai	unknown	unknown
-	SENT	-
o/futo/s	adjective	ἐλαιοφυτός
te	particle	τε/??/οὔτε
*sa/mos	noun	σάμος
,	SENT	,
*xi/os	noun	χίος
h)de\	conjunction	ἠδέ
*pa/ros	noun	Πάρος
,	SENT	,
*na/cos	noun	Νάξος
,	SENT	,
*mu/ko	unknown	unknown
-	SENT	-
nos	noun	Μύκονος
,	SENT	,
*th/nw|	noun	τήνος
te	particle	τε/??/οὔτε
suna/ptous'	verb	συνάπτω
*)andros	noun	Ἄνδρος
a)gxigei/twn	adjective	ἀγχιγείτων
,	SENT	,
kai\	conjunction	???/καί
ta\s	article	ὁ
a)gxia/lous	adjective	ἀγχίαλος
e)kra/tune	verb	κρατύνω
mesa/ktous	adjective	μέσακτος
,	SENT	,
*lh=mnon	noun	Λῆμνος/λῆμνος
,	SENT	,
*)ika/rou	noun	Ἴκαρος
q'	particle	τε
e(/dos	noun	ἕδος
,	SENT	,
kai\	conjunction	???/καί
*(ro/don	noun	ῥόδον/Ῥόδος
h)de\	conjunction	ἠδέ
*kni/don	proper	Κνίδος
*kupri/as	adjective	Κύπριος
te	particle	τε/??/οὔτε
po/leis	noun	πολίς/πόλις/πόόλις
,	SENT	,
*pa/fon	noun	Πάφος/πάφος
,	SENT	,
h)de\	conjunction	ἠδέ
*so/lous	noun	σόλος
,	SENT	,
*salami=na/	noun	Σαλαμίς
te	particle	τε/??/οὔτε
,	SENT	,
ta=s	article	ὁ
nu=n	adverb	νῦν#1/νῦν
matro/polis	noun	μητρόπολις
tw=nd'	pronoun	ὅδε
ai)ti/a	noun	αἰτία
stenagmw=n	noun	στεναγμός
.	SENT	.
kai\	conjunction	???/καί
ta\s	article	ὁ
eu)ktea/nous	adjective	εὐκτέανος
kata\	preposition	κατά
klh=ron	noun	κλῆρος
*)iao/nion	adjective	̓ἰαόνιος
polua/ndrous	adjective	πολύανδρος
*(ella/nwn	noun	Ἕλλην/῞ἕλλην
e)kra/tei	verb	κρατέω
sfete/rais	adjective	σφέτερος
fresi/n	noun	φρήν
.	SENT	.
a)ka/maton	adjective	ἀκάματος
de\	particle	μηδέ/δέ/οὐδέ
parh=n	verb	πάρειμι/πάρειμι#1
sqe/nos	noun	σθένος
a)ndrw=n	noun	ἀνήρ
teuxhsth/rwn	noun	τευχηστήρ
pammi/ktwn	adjective	πάμμικτος/παμμιγής
t'	particle	τε
e)pikou/rwn	noun	ἐπίκουρος
.	SENT	.
nu=n	adverb	νῦν#1/νῦν
d'	particle	οὐδέ/δέ/??
ou)k	adverb	οὐ
a)mfilo/gws	adjective	ἀμφίλογος
qeo/trepta	adjective	θεότρεπτος
ta/d'	pronoun	ὅδε
au)=	adverb	αὖ/αὗ
fe/romen	verb	φέρω
pole/moisi	noun	πόλεμος
dmaqe/ntes	verb	δαμάζω
mega/lws	adverb	μέγας/μεγάλως
plagai=si	noun	πληγή
ponti/aisin	adjective	πόντιος
.	SENT	.
i)w/	interjection	ἰώ
,	SENT	,
du/sthnos	adjective	δύστηνος
e)gw\	pronoun	ἐγώ
stugera=s	adjective	στυγερός
moi/ras	noun	μοῖρα
th=sde	pronoun	ὅδε
kurh/sas	verb	κυρέω
a)tekmartota/ths	adjective	ἀτέκμαρτος
,	SENT	,
w(s	conjunction	ὥς/ὡς
w)mofro/nws	adverb	ὠμόφρων
dai/mwn	noun	δαίμων
e)ne/bh	verb	ἐμβαίνω
*persw=n	noun	Πέρσης/Ρέρσης/πέρσης
genea=|	noun	γενεά
:	SENT	:
ti/	pronoun	τις/τίς/τὶς
pa/qw	verb	πάσχω
tlh/mwn	adjective	τλήμων
;	SENT	;
le/lutai	verb	λύω
ga\r	particle	γάρ
e)moi\	pronoun	ἐμός/ἐγώ
gui/wn	noun	γυῖον
r(w/mh	noun	ῥώμη
th/nd'	pronoun	ὅδε
h(liki/an	noun	ἡλικία
e)sido/nt'	verb	εἰσεῖδον/εἰσοράω
a)stw=n	noun	ἀστός/ἀστή/ἄστυ
.	SENT	.
ei)/q'	conjunction	εἴτε
o)/felen	verb	ὀφείλω
,	SENT	,
*zeu=	noun	Ζεύς/ζεύς
,	SENT	,
ka)me\	pronoun	ἐγώ
met'	preposition	μετα/μετά
a)ndrw=n	noun	ἀνήρ
tw=n	article	ὁ/ὅς
oi)xome/nwn	verb	οἴχομαι
qana/tou	noun	θάνατος
kata\	preposition	κατά
moi=ra	noun	μοῖρα
kalu/yai	verb	καλύπτω
.	SENT	.
o)totoi=	interjection	ὀτοτοῖ
,	SENT	,
basileu=	noun	βασιλεύς
,	SENT	,
stratia=s	noun	στρατία/στρατιά
a)gaqh=s	adjective	ἀγαθός
kai\	conjunction	???/καί
persono/mou	adjective	Περσονόμος
timh=s	noun	τιμὴ/τιμή
mega/lhs	adjective	μέγας
,	SENT	,
ko/smou	noun	κόσμος
t'	particle	τε
a)ndrw=n	noun	ἀνήρ
,	SENT	,
ou(\s	pronoun	ὁ/ὅς
nu=n	adverb	νῦν#1/νῦν
dai/mwn	noun	δαίμων
e)pe/keiren	verb	ἐπικείρω
.	SENT	.
ga=	noun	γῆ
d'	particle	οὐδέ/δέ/??
ai)a/zei	verb	αἰάζω
ta\n	article	ὁ
e)ggai/an	adjective	ἐγγαιος/ἔγγαιος
h(/ban	noun	ἥβη
*ce/rca|	noun	Ξέρξης
ktame/nan	verb	κτείνω/κτάομαι
*(/aidou	noun	Ἅιδης/῞ᾅδης/ᾍδης
sa/ktori	noun	σάκτωρ
*persa=n	noun	Πέρσης/πέρσης
.	SENT	.
a(|doba/tai	adjective	ᾁδοβάτης
ga\r	particle	γάρ
polloi\	adjective	πολύς
fw=tes	noun	φώς
,	SENT	,
xw/ras	noun	χώρα
a)/nqos	noun	ἄνθος
,	SENT	,
tocoda/mantes	adjective	τοξόδαμνος
,	SENT	,
pa/nu	adverb	πάνυ
tarfu/s	adjective	ταρφύς
tis	pronoun	τις/τίς/τὶς
muria\s	noun	μυριάς
a)ndrw=n	noun	ἀνήρ
,	SENT	,
e)ce/fqintai	verb	ἐκφθίνω
.	SENT	.
ai)ai=	interjection	αἰαῖ
ai)ai=	interjection	αἰαῖ
kedna=s	adjective	κεδνός
a)lka=s	noun	ἀλκή
.	SENT	.
*)asi/a	noun	Ἀσία/Ἀαία
de\	particle	μηδέ/δέ/οὐδέ
xqw/n	noun	χθών
,	SENT	,
basileu=	noun	βασιλεύς
gai/as	noun	γαῖα
,	SENT	,
ai)nw=s	adverb	αἰνός/αἰνῶς
ai)nw=s	adverb	αἰνός/αἰνῶς
e)pi\	preposition	ἐπί
go/nu	noun	γόνυ
ke/klitai	verb	κλίνω
.	SENT	.
o(/d'	pronoun	ὅδε
e)gw/	pronoun	ἐγώ
,	SENT	,
oi)oi=	interjection	οἰοῖ/οἶ
,	SENT	,
ai)akto\s	adjective	αἰακτός
me/leos	adjective	μέλεος
ge/nna|	noun	γέννα/γέννας
ga=|	noun	ὀργή/γῆ
te	particle	τε/??/οὔτε
patrw/|a|	adjective	πατρώιος/πατρῷος
kako\n	adjective	κακός
a)/r'	particle	ἄρα
e)geno/man	verb	γίγνομαι
.	SENT	.
pro/sfqoggo/n	adjective	πρόσφθογγος
soi	pronoun	σοι/σύ
no/stou	noun	νόστος
ta\n	article	ὁ
kakofa/tida	noun	κακόφατις
boa/n	noun	βοή
,	SENT	,
kakome/leton	adjective	κακομέλετος
i)a\n	noun	ἰά
*mariandunou=	noun	μαριανδυνός
qrhnhth=ros	noun	θρηνητήρ
pe/myw	verb	πέμπω
pe/myw	verb	πέμπω
,	SENT	,
polu/dakrun	adjective	πολύδακρυς
i)axa/n	noun	ἰαχή
.	SENT	.
i(/et'	verb	ἵημι
ai)anh=	adjective	αἰανής
[kai\]	conjunction	καί
pa/ndurton	adjective	πάνδυρτος
du/sqroon	adjective	δύσθρους/δύσθροος
au)da/n	noun	αὐδή
.	SENT	.
dai/mwn	noun	δαίμων
ga\r	particle	γάρ
o(/d'	pronoun	ὅδε
au)=	adverb	αὖ/αὗ
meta/tropos	adjective	μετάτροπος
e)p'	preposition	ἐπί/ἐπι
e)moi/	pronoun	ἐγώ
.	SENT	.
h(/sw	verb	ἥδομαι/ἕζομαι/ἵημι
toi	pronoun	σύ
ta\n	article	ὁ
pa/ndurton	adjective	πάνδυρτος
,	SENT	,
sa\	adjective	σός
pa/qh	noun	πάθη/πάθος
te	conjunction	τε/ὅτε
se/bwn	verb	σέβω
a(li/tupa/	adjective	ἁλίτυπος
te	particle	τε/??/οὔτε
ba/rh	noun	βᾶρις/βάρος
,	SENT	,
po/lews	noun	πόλις
ge/nnas	noun	γέννα/γέννας
penqhth=ros	noun	πενθητήρ
:	SENT	:
kla/gcw	verb	κλάζω
kla/gcw	verb	κλάζω
de\	adverb	δέ/οὐ
go/on	noun	γόος
a)ri/dakrun	adjective	ἀρίδακρυς
.	SENT	.
*)ia/nwn	noun	̓ἰάν
ga\r	particle	γάρ
a)phu/ra	verb	ἀπαυράω
,	SENT	,
*)ia/nwn	noun	̓ἰάν
nau/fraktos	adjective	ναύφρακτος
*)/arhs	noun	῎ἄρης/Ἄρης
e(teralkh\s	adjective	ἑτεραλκής
nuxi/an	adjective	νύχιος
pla/ka	noun	πλάξ
kersa/menos	verb	κείρω
dusdai/mona/	adjective	δυσδαίμων
t'	particle	τε
a)kta/n	noun	ἀκτή
.	SENT	.
oi)oioi=	interjection	οἰοιοῖ
bo/a	noun	βοῦς/βόα
kai\	conjunction	???/καί
pa/nt'	adjective	πα~ς/πᾶς/π͂ας
e)kpeu/qou	verb	ἐκπεύθομαι
.	SENT	.
-	SENT	-
pou=	adverb	ποῦ/πού
de\	particle	μηδέ/δέ/οὐδέ
fi/lwn	adjective	φίλος
a)/llos	adjective	ἄλλος
o)/xlos	noun	ὄχλος
,	SENT	,
pou=	adverb	ποῦ/πού
de/	particle	δέ/οὐδέ
soi	pronoun	σοι/σύ
parasta/tai	noun	παραστάτης
,	SENT	,
oi(=os	adjective	οἷος#1/οἷος
h)=n	verb	είμί/εἰμί#1/εἰμί/ἠμί
*faranda/khs	noun	Φαρανδάκης
,	SENT	,
*sou/sas	noun	Σούσας
,	SENT	,
*pela/gwn	noun	Πελάγων
,	SENT	,
[kai\]	conjunction	καί
*dota/mas	noun	Δοτάμας
,	SENT	,
h)d'	conjunction	ἠδέ/ἠδη
*)a	unknown	unknown
-	SENT	-
gdaba/tas	noun	Ἀγδαβάτας
,	SENT	,
*ya/mmis	noun	Ψάμμις
,	SENT	,
*sousiska/nhs	noun	Σουσισκάνης
t'	particle	τε
*)agba/tana	noun	Ἀγβάτανα
lipw/n	verb	λείπω
;	SENT	;
o)loou\s	adjective	ὀλοός
a)pe/leipon	verb	ἀπολιμπάνω/ἀπολείπω
*turi/as	adjective	Τύριος
e)k	preposition	ἐκ
nao\s	noun	ναῦς/ναός
e)/rrontas	verb	ἔρρω
e)p'	preposition	ἐπί/ἐπι
a)ktai=s	noun	ἀκτή/ἀκτέα
*salaminia/si	adjective	Σαλαμινιάς
stufelou=	adjective	στυφελός
qei/nontas	verb	θείνω
e)p'	preposition	ἐπί/ἐπι
a)kta=s	noun	ἀκτή/ἀκτέα
.	SENT	.
oi)oioi=	interjection	οἰοιοῖ
,	SENT	,
bo/a	verb	βοάω
:	SENT	:
pou=	adverb	ποῦ/πού
soi	pronoun	σοι/σύ
*farnou=xos	noun	Φαρνοῦχος
*)ario/mardo/s	noun	Ἀριόμαρδός
t'	particle	τε
a)gaqo/s	adjective	ἀγαθός
,	SENT	,
pou=	adverb	ποῦ/πού
de\	particle	μηδέ/δέ/οὐδέ
*seua/lkhs	noun	Σευάλκης
a)/nac	noun	ἄναξ
,	SENT	,
h)\	conjunction	ἤ
*li/laios	noun	Λίλαιος
eu)pa/twr	noun	εὐπάτωρ
,	SENT	,
*me/mfis	noun	Μέμφις
,	SENT	,
*qa/rubis	noun	Θάρυβις
,	SENT	,
kai\	conjunction	???/καί
*masi/stras	noun	Μασίστρας
,	SENT	,
*)artemba/rhs	noun	Ἀρτεμβάρας/Ἀρτεμβάρης
t'	particle	τε
h)d'	conjunction	ἠδέ/ἠδη
*(ustai/xmas	noun	Ὑσταίχμας
;	SENT	;
ta/de	pronoun	ὅδε
s'	pronoun	συ/σύ/σοί
e)panero/man	verb	ἐπανέρομαι
.	SENT	.
i)w\	interjection	ἰώ
i)w/	interjection	ἰώ
moi/	pronoun	ἐγώ
moi	pronoun	τις/ἐγώ
ta\s	article	ὁ
w)gugi/ous	adjective	̓ὠγύγιος/ὠγύγιος
katido/ntes	verb	κατεῖδον
stugna\s	adjective	στυγνός
*)aqa/nas	noun	Ἀθῆναι/Ἀθήνη
pa/ntes	adjective	πᾶς
e(ni\	adjective	εἷς
pitu/lw|	noun	πίτυλος
,	SENT	,
e)h\	interjection	ἐή
e)h/	interjection	ἐή
,	SENT	,
tla/mones	noun	τλήμων
a)spai/rousi	verb	ἀσπαίρω
xe/rsw|	noun	χέρσος
.	SENT	.
h)=	adverb	ἦ/ἦ#2
kai\	conjunction	???/καί
to\n	article	ὁ/τὸν
*persa=n	noun	Πέρσης/πέρσης
au)tou=	pronoun	αὐτοός/αὐτός
to\n	article	ὁ/τὸν
so\n	adjective	σός
pisto\n	adjective	πιστός
pa/nt'	adjective	πα~ς/πᾶς/π͂ας
o)fqalmo\n	noun	ὀφθαλμός
muri/a	adjective	μυρίος
muri/a	adjective	μυρίος
pempasta\n	noun	πεμπαστής
*batanw/xou	noun	Βατάνωχος
pai=d'	noun	παῖς/παι~ς
*)/alpiston	noun	Ἄλπιστον
tou=	article	ὁ/ὅς/τὁ/ὀ
*shsa/ma	noun	Σησάμης
tou=	article	ὁ/ὅς/τὁ/ὀ
*megaba/ta	noun	Μεγαβάτης
,	SENT	,
*pa/rqon	noun	Πάρθος
te	particle	τε/??/οὔτε
me/gan	adjective	μέγας
t'	particle	τε
*oi)ba/rhn	noun	Οἰβάρης
e)/lipes	verb	λείπω
e)/lipes	verb	λείπω
;	SENT	;
w)\	interjection	ὦ
w)\	interjection	ὦ
w)\	interjection	ὦ
da/|wn	adjective	δάιος/δᾷος
.	SENT	.
*pe/rsais	noun	Πέρσης/πέρσης
a)gauoi=s	adjective	ἀγαυός
kaka\	adjective	κακός
pro/kaka	adjective	πρόκακος
le/geis	verb	λέγω
.	SENT	.
i)w\	interjection	ἰώ
i)w\	interjection	ἰώ
dh=ta	adverb	δῆτα
i)/ugg'	noun	ἴυγξ
a)gaqw=n	adjective	ἀγαθός
e(ta/rwn	noun	ἑταῖρος
moi	pronoun	τις/ἐγώ
[u(pomimnh/skeis]	verb	ὑπομιμνήσκω
kinei=s	verb	κινέω
a)/lasta	adjective	ἄλαστος
stugna\	adjective	στυγνός
pro/kaka	adjective	πρόκακος
le/gwn	verb	λέγω
.	SENT	.
boa=|	verb	βοάω
boa=|	verb	βοάω
moi	pronoun	τις/ἐγώ
mele/wn	noun	μέλη/μέλος
e)/ntosqen	preposition	ἔντοσθε/ἔντοσθεν
h)=tor	noun	ἦτορ/ἤτορ
.	SENT	.
kai\	conjunction	???/καί
mh\n	particle	μήν
a)/llous	pronoun	ἄλλος
ge	adverb	γε
poqou=men	verb	ποθέω
,	SENT	,
*ma/rdwn	noun	Μάρδων/Μάρδος
a)ndrw=n	noun	ἀνήρ
muriotago\n	adjective	μυριοταγός
*ca/nqin	noun	Ξάνθις
a)/reio/n	adjective	ἄρειος
t'	particle	τε
*)agxa/rhn	noun	Ἀγχάρης
,	SENT	,
*di/aici/n	noun	Δίαιξις
t'	particle	τε
h)d'	conjunction	ἠδέ/ἠδη
*)arsa/khn	noun	Ἀρσάκης
i(ppia/naktas	noun	ἱππιάναξ
,	SENT	,
*khgdada/tan	noun	Κηγδαδάτας
kai\	conjunction	???/καί
*luqi/mnan	noun	Λυθίμναν
*to/lmon	noun	Τόλμος
t'	particle	τε
ai)xma=s	noun	αἰχμή
a)ko/reston	adjective	ἀκόρεστος
.	SENT	.
e)/tafon	verb	τέθηπα
e)/tafon	verb	τέθηπα
,	SENT	,
ou)k	adverb	οὐ
a)mfi\	preposition	ἀμφί
skhnai=s	noun	σκηνή
troxhla/toisin	adjective	τροχήλατος
o)/piqen	adverb	ὄπισθεν
e(pome/nous	verb	ἕπομαι
.	SENT	.
beba=si	verb	βαίνω
ga\r	particle	γάρ
toi/per	particle	τοι
a)gre/tai	noun	ἀγρέτης
stratou=	noun	στρατός
.	SENT	.
beba=sin	verb	βαίνω
,	SENT	,
oi)/	interjection	οἰ/οἴ
,	SENT	,
nw/numoi	adjective	νώνυμος
.	SENT	.
i)h\	interjection	ἰή
i)h/	interjection	ἰή
,	SENT	,
i)w\	interjection	ἰώ
i)w/	interjection	ἰώ
.	SENT	.
i)w\	interjection	ἰώ
i)w/	interjection	ἰώ
,	SENT	,
dai/mones	noun	δαίμων
,	SENT	,
e)/qeq'	verb	ἔθω/τίθημι
a)/elpton	adjective	ἄελπτος
kako\n	adjective	κακός
diapre/pon	verb	διαπρέπω
,	SENT	,
oi(=on	adjective	οἷος
de/dorken	verb	δέρκομαι
*)/ata	noun	ἄτη
.	SENT	.
peplh/gmeq'	verb	πλήσσω
oi(/a|	adjective	οἷος
di'	preposition	διά/διὰ/διάπλοο/διό
ai)w=nos	noun	αἰών
tu/xa|	noun	τύχη
:	SENT	:
peplh/gmeq'	verb	πλήσσω
:	SENT	:
eu)/dhla	adjective	εὔδηλος
ga/r	particle	γάρ
:	SENT	:
ne/a|	adjective	νέος/νέα
ne/a|	adjective	νέος/νέα
du/a|	noun	δύη
du/a|	noun	δύη
.	SENT	.
ku/rsantes	verb	κυρέω
ou)k	adverb	οὐ
eu)tuxw=s	adverb	εὐτυχής
*)ia/nwn	noun	̓ἰάν
naubata=n	noun	ναυβάτης
.	SENT	.
duspo/lemon	adjective	δυσπόλεμος
dh\	particle	δή
ge/nos	noun	γένος
to\	article	ὁ
*persa=n	noun	Πέρσης/πέρσης
.	SENT	.
pw=s	adverb	πως/πῶς
d'	particle	οὐδέ/δέ/??
ou)/	adverb	οὔπως/οὔτι/οὔτε/οὐ
;	SENT	;
strato\n	noun	στρατός
me\n	particle	μέν
tosou=	unknown	unknown
-	SENT	-
ton	article	ὁ
ta/las	adjective	τάλας
pe/plhgmai	verb	πλήσσω
.	SENT	.
ti/	pronoun	τις/τίς/τὶς
d'	particle	οὐδέ/δέ/??
ou)/k	adverb	οὐ
;	SENT	;
o)/lwlen	verb	ὄλλυμι
mega/lws	adverb	μέγας/μεγάλως
ta\	article	ὁ/τίς
*persa=n	noun	Πέρσης/πέρσης
.	SENT	.
o(ra=|s	verb	ὁράω
to\	article	ὁ
loipo\n	adjective	λοιπός
to/de	pronoun	ὅδε
ta=s	article	ὁ
e)ma=s	adjective	ἐμός
stola=s	noun	στολή
;	SENT	;
o(rw=	verb	ὁράω
o(rw=	verb	ὁράω
.	SENT	.
to/nde	pronoun	ὅδε
t'	particle	τε
o)istode/gmona	adjective	ὀιστοδέγμων
-	SENT	-
ti/	pronoun	τις/τίς/τὶς
to/de	pronoun	ὅδε
le/geis	verb	λέγω
seswsme/non	verb	σώζω
;	SENT	;
qhsauro\n	noun	θησαυρός
bele/essin	noun	βέλος
;	SENT	;
baia/	adjective	βαιός
g'	particle	γε
w(s	adverb	ὡς#2/ʽὡς/ὥς/ὡς
a)po\	preposition	ἀπό
pollw=n	adjective	πολύς
.	SENT	.
e)spani/smeq'	verb	σπανίζω
a)rwgw=n	adjective	ἀρωγός/ἀρωγή
.	SENT	.
*)ia/nwn	noun	̓ἰάν
lao\s	noun	λαός
ou)	adverb	οὐκ/οὔπως/οὐ
fugai/xmas	noun	φυγαίχμης
.	SENT	.
a)gano/reios	noun	ἀγήνωρ
:	SENT	:
katei=-	unknown	unknown
don	verb	κατεῖδον
de\	adverb	δέ/οὐ
ph=m'	noun	πῆμα
a)/elpton	adjective	ἄελπτος
.	SENT	.
trape/nta	verb	τέρπω/τρέπω
nau/frakton	adjective	ναύφρακτος
e)rei=s	verb	λέγω/ἐρῶ/ἐρέω
o(/milon	noun	ὅμιλος
;	SENT	;
pe/plon	noun	πεπλος/πέπλος
d'	particle	οὐδέ/δέ/??
e)pe/rrhc'	verb	ἐπιρράσσω/ἐπιρρήγνυμι
e)pi\	preposition	ἐπί
sumfora=|	noun	συμφορά
kakou=	adjective	κακός/κακός·
.	SENT	.
papai=	interjection	παπαῖ
papai=	interjection	παπαῖ
.	SENT	.
kai\	conjunction	???/καί
ple/on	adjective	πλέος/πλείων/πλέως/πολύς
h)\	conjunction	ἤ
papai=	interjection	παπαῖ
me\n	adverb	μέν
ou)=n	adverb	οὖν
.	SENT	.
di/duma	adjective	δίδυμος
ga/r	particle	γάρ
e)sti	verb	εἰμί#1/εἰμί
kai\	conjunction	???/καί
tripla=	adjective	τριπλόος
-	SENT	-
lupra/	adjective	λυπρός
,	SENT	,
xa/rmata	noun	χάρμα
d'	particle	οὐδέ/δέ/??
e)xqroi=s	adjective	ἐχθρός
.	SENT	.
kai\	conjunction	???/καί
sqe/nos	noun	σθένος
g'	particle	γε
e)kolou/sqh	verb	κολούω
-	SENT	-
gumno/s	adjective	γυμνός
ei)mi	verb	εἰμί#1/εἰμί
propompw=n	adjective	προπομπός
.	SENT	.
fi/lwn	adjective	φίλος
a)/taisi	noun	ἄτη
ponti/aisin	adjective	πόντιος
:	SENT	:
di/aine	verb	διαίνω
di/aine	verb	διαίνω
ph=ma	noun	πῆμα
:	SENT	:
pro\s	preposition	πρός
do/mous	noun	δόμος
d'	particle	οὐδέ/δέ/??
i)/qi	verb	εἶμι#2/εἶμι
.	SENT	.
ai)ai=	interjection	αἰαῖ
ai)ai=	interjection	αἰαῖ
,	SENT	,
du/a	noun	δύη
du/a	noun	δύη
.	SENT	.
bo/a	verb	βοάω
nun	adverb	νῦν#1/νῦν/νυν#2
a)nti/doupa/	adjective	ἀντίδουπος
moi	pronoun	τις/ἐγώ
.	SENT	.
do/sin	noun	δόσις
kaka\n	adjective	κακός
kakw=n	adjective	κακός
kakoi=s	adjective	κακός
.	SENT	.
i)/uze	verb	ἰύζω
me/los	noun	μέλος
o(mou=	adverb	ὁμοῦ
tiqei/s	verb	τίθημι
.	SENT	.
o)totototoi=	interjection	ὀτοτοῖ
.	SENT	.
barei=a/	adjective	βαρύς
g'	particle	γε
a(/de	pronoun	ὅδε
sumfora/	noun	συμφορά
.	SENT	.
oi)\	interjection	ὄι/οἰ/οἴ
ma/la	adverb	μάλα
kai\	conjunction	???/καί
to/d'	pronoun	ὅδε
a)lgw=	verb	ἀλγέω
.	SENT	.
e)/ress'	noun	ἔρσην/ἔρος
e)/resse	verb	ἐρέσσω
kai\	conjunction	???/καί
ste/naz'	verb	στενάζω
e)mh\n	adjective	ἐμός
xa/rin	noun	χάρις
.	SENT	.
diai/nomai	verb	διαίνω
goedno\s	adjective	γοερός
w)/n	verb	εἰμί#1/εἰμί
.	SENT	.
bo/a	verb	βοάω
nun	adverb	νῦν#1/νῦν/νυν#2
a)nti/doupa/	adjective	ἀντίδουπος
moi	pronoun	τις/ἐγώ
.	SENT	.
me/lein	verb	μέλω
pa/resti	verb	πάρειμι/πάρειμι#1
,	SENT	,
de/spota	noun	δεσπότης
.	SENT	.
e)porqi/aze/	verb	ἐπορθιάζω
nun	adverb	νῦν#1/νῦν/νυν#2
go/ois	noun	γόος
.	SENT	.
o)totototoi=	interjection	ὀτοτοῖ
.	SENT	.
me/laina	adjective	μέλας
d'	particle	οὐδέ/δέ/??
a)mmemei/cetai	verb	ἀναμίγνυμι
,	SENT	,
oi)/	interjection	οἰ/οἴ
,	SENT	,
stono/essa	adjective	στονόεις
plaga/	noun	πληγή
.	SENT	.
kai\	conjunction	???/καί
ste/rn'	noun	στέρνον
a)/rasse	verb	ἀράζω/ἀράσσω
ka)pibo/a	verb	ἐπιβοάω
to\	article	ὁ
*mu/sion	adjective	μύσιος/Μύσιος
.	SENT	.
a)/ni'	adjective	ἄνιος
a)/nia	adjective	ἄνιος
.	SENT	.
kai/	conjunction	καί
moi	pronoun	τις/ἐγώ
genei/ou	noun	γένειον
pe/rqe	verb	πέρθω
leukh/rh	adjective	λευκήρης
tri/xa	noun	θρίξ
.	SENT	.
a)/prigd'	adverb	ἄπριγδα
a)/prigda	adverb	ἄπριγδα
ma/la	adverb	μάλα
goedna/	adjective	γοερός/γοεδνός
.	SENT	.
a)u/tei	verb	ἀυτέω
d'	particle	οὐδέ/δέ/??
o)cu/	adjective	ὀξύς
.	SENT	.
kai\	conjunction	???/καί
ta/d'	pronoun	ὅδε
e)/rcw	verb	ἔρδω/ἔργω
.	SENT	.
pe/plon	noun	πεπλος/πέπλος
d'	particle	οὐδέ/δέ/??
e)/reike	verb	ἐρέικω
kolpi/an	noun	κολπίας
a)kmh=|	noun	ἀκμή
xerw=n	noun	χείρ
.	SENT	.
a)/ni'	adjective	ἄνιος
a)/nia	adjective	ἄνιος
.	SENT	.
kai\	conjunction	???/καί
ya/ll'	verb	ψάλλω
e)/qeiran	noun	ἔθειρα
kai\	conjunction	???/καί
katoi/ktisai	verb	κατοικτίζω
strato/n	noun	στρατός
.	SENT	.
a)/prigd'	adverb	ἄπριγδα
a)/prigda	adverb	ἄπριγδα
ma/la	adverb	μάλα
goedna/	adjective	γοερός/γοεδνός
.	SENT	.
diai/nou	verb	διαίνω
d'	particle	οὐδέ/δέ/??
o)/sse	noun	ὄσσε/ὄσσα
.	SENT	.
te/ggomai/	verb	τέγγω
toi	particle	τοι
.	SENT	.
bo/a	verb	βοάω
nun	adverb	νῦν#1/νῦν/νυν#2
a)nti/doupa/	adjective	ἀντίδουπος
moi	pronoun	τις/ἐγώ
.	SENT	.
oi)oi=	interjection	οἰοῖ/οἶ
oi)oi=	interjection	οἰοῖ/οἶ
.	SENT	.
ai)akto\s	adjective	αἰακτός
e)s	preposition	εἰς
do/mous	noun	δόμος
ki/e	verb	κίω
.	SENT	.
i)w\	interjection	ἰώ
i)w/	interjection	ἰώ
,	SENT	,
[*persi\s	noun	Περσίς
ai)=a	noun	γαῖα/αἶα
du/sbatos]	adjective	δύσβατος
.	SENT	.
i)w\	interjection	ἰώ
i)w/	interjection	ἰώ
,	SENT	,
*persi\s	noun	Περσίς
ai)=a	noun	γαῖα/αἶα
du/sbatos	adjective	δύσβατος
.	SENT	.
i)h\	interjection	ἰή
i)h\	interjection	ἰή
triska/lmoisin	adjective	τρίσκαλμος
,	SENT	,
i)h\	interjection	ἰή
i)h/	interjection	ἰή
,	SENT	,
ba/risin	noun	βᾶρις
o)lo/menoi	adjective	οὐλόμενος
.	SENT	.
pe/myw	verb	πέμπω
toi/	particle	τοι
se	pronoun	σύ
dusqro/ois	adjective	δύσθρους/δύσθροος
go/ois	noun	γόος
.	SENT	.
