Τάδε	pronoun	ὅδε
μὲν	particle	μέν
Περσῶν	noun	Πέρσης/Ρέρσης/πέρσης
τῶν	article	ὁ/ὅς
οἰχομένων	verb	οἴχομαι
Ἑλλάδ̓	verb	<unknown>
ἐς	preposition	εἰς
αἶαν	noun	αἶα
πιστὰ	adjective	πιστός
καλεῖται	verb	καλέω
,	SENT	,
καὶ	conjunction	???/καί
τῶν	article	ὁ/ὅς
ἀφνεῶν	adjective	ἀφνειός
καὶ	conjunction	???/καί
πολυχρύσων	adjective	πολύχρυσος
ἑδράνων	noun	ἕδρανον
φύλακες	noun	φύλαξ
,	SENT	,
κατὰ	preposition	κατά
πρεσβείαν	noun	πρεσβεία
οὓς	pronoun	ὁ/ὅς
αὐτὸς	adjective	αὐτός
ἄναξ	noun	ἄναξ
Ξέρξης	proper	Ξέρξης
βασιλεὺς	noun	βασιλεύς
Δαρειογενὴς	adjective	Δαρειογενής
εἵλετο	verb	αἱρέω
χώρας	noun	χώρα
ἐφορεύειν	verb	ἐφορεύω
.	SENT	.
ἀμφὶ	preposition	ἀμφί
δὲ	particle	μηδέ/δέ/οὐδέ
νόστῳ	noun	νόστος
τῷ	article	ὁ
βασιλείῳ	noun	βασίλειον
καὶ	conjunction	???/καί
πολυχρύσου	adjective	πολύχρυσος
στρατιᾶς	noun	στρατία/στρατιά
ἤδη	adverb	ἠδή/ἤδη/ἦδη
κακόμαντις	noun	κακόμαντις
ἄγαν	adverb	ἄγαν
ὀρσολοπεῖται	verb	ὀρσολοπεύω/ὀρσολοπέω
θυμὸς	noun	θυμός
ἔσωθεν	adverb	ἔσωθεν
.	SENT	.
πᾶσα	pronoun	πᾶς
γὰρ	particle	γάρ
ἰσχὺς	noun	ἰσχύς
Ἀσιατογενὴς	adjective	Ἀσιατογενής
ᾤχωκε	verb	οἴχομαι
,	SENT	,
νέον	adjective	νέος
δ̓	adjective	<unknown>
ἄνδρα	noun	ἀνήρ
βαΰζει	verb	βαύζω
,	SENT	,
κοὔτε	adverb	οὔτε
τις	pronoun	τις/τίς/τὶς
ἄγγελος	noun	ἄγγελος
οὔ	adverb	οὔπως/οὔτι/οὔτε/οὐ
τε	adverb	τε/οὔτε
τις	pronoun	τις/τίς/τὶς
ἱππεὺς	noun	ἱππεύς
ἄστυ	noun	ἄστυ
τὸ	article	ὁ
Περσῶν	noun	Πέρσης/Ρέρσης/πέρσης
ἀφικνεῖται	verb	ἀφικνέομαι
·	SENT	:
οἵτε	pronoun	ὅστε
τὸ	article	ὁ
Σούσων	proper	Σοῦσος/Σοῦσα
ἠδ̓	verb	<unknown>
Ἀγβατάνων	noun	/Ἐκβάτανα
καὶ	conjunction	???/καί
τὸ	article	ὁ
παλαιὸν	adjective	παλαιός
Κίσσιον	adjective	Κίσσιος
ἕρκος	noun	ἕρκος
προλιπόντες	verb	προλείπω
ἔβαν	verb	βαίνω
,	SENT	,
τοὶ	pronoun	ὁ//σύ/ὅς
μὲν	particle	μέν
ἐφ̓	verb	<unknown>
ἵππων	noun	ἵππος
,	SENT	,
τοὶ	pronoun	ὁ//σύ/ὅς
δ̓	verb	<unknown>
ἐπὶ	preposition	ἐπί
ναῶν	noun	ναῦς/ναός
,	SENT	,
πεζοί	adjective	πεζός
τε	particle	τε/??/οὔτε
βάδην	adverb	βάδην
πολέμου	noun	πολεμός/πόλεμος
στῖφος	noun	στῖφος
παρέχοντες	verb	παρέχω
·	SENT	:
οἷος	adjective	οἷος#1/οἷος
Ἀμίστρης	noun	ἀμίστρης
ἠδ̓	verb	<unknown>
Ἀρταφρένης	proper	Ἀρταφρένης
καὶ	conjunction	???/καί
Μεγαβάτης	proper	Μεγαβάτης
ἠδ̓	verb	<unknown>
Ἀστάσπης	noun	ἀστασπης
,	SENT	,
ταγοὶ	noun	ταγός
Περσῶν	noun	Πέρσης/Ρέρσης/πέρσης
,	SENT	,
βασιλῆς	noun	βασιλεύς
βασιλέως	noun	βασιλεύς
ὕποχοι	adjective	ὕποχος
μεγάλου	adjective	μέγας
,	SENT	,
σοῦνται	verb	σεύω/σέω
,	SENT	,
στρατιᾶς	noun	στρατία/στρατιά
πολλῆς	adjective	πολύς
ἔφοροι	noun	ἔφορος
,	SENT	,
τοξοδάμαντές	noun	τοξοδάμας
τ̓	adjective	<unknown>
ἠδ̓	verb	<unknown>
ἱπποβάται	noun	ἱπποβάτης
,	SENT	,
φοβεροὶ	adjective	φοβερός
μὲν	particle	μέν
ἰδεῖν	verb	ἰδέω/εἶδον/ὁράω
,	SENT	,
δεινοὶ	adjective	δεινός
δὲ	particle	μηδέ/δέ/οὐδέ
μάχην	noun	μαχή/μάχη
ψυχῆς	noun	ψυχή
εὐτλήμονι	adjective	εὐτλήμων
δόξῃ	noun	δόξις/δόξα
·	SENT	:
Ἀρτεμβάρης	noun	Ἀρτεμβάρας/Ἀρτεμβάρης
θ̓	adjective	<unknown>
ἱππιοχάρμης	noun	ἱππιοχάρμης
καὶ	conjunction	???/καί
Μασίστρης	noun	μασίστρης
,	SENT	,
ὅ	pronoun	/ὅ/ὅστις/ὁς/ὅς/ὁ
τε	particle	τε/??/οὔτε
τοξοδάμας	adjective	τοξόδαμνος
ἐσθλὸς	adjective	ἐσθλός
Ἰμαῖος	noun	Ἰμαῖος
,	SENT	,
Φαρανδάκης	noun	Φαρανδάκης
θ̓	verb	<unknown>
,	SENT	,
ἵππων	noun	ἵππος
τ̓	adjective	<unknown>
ἐλατὴρ	noun	ἐλατήρ
Σοσθάνης	noun	Σοσθάνης
.	SENT	.
ἄλλους	pronoun	ἄλλος
δ̓	verb	<unknown>
ὁ	article	ὁ
μέγας	adjective	μέγας
καὶ	conjunction	???/καί
πολυθρέμμων	adjective	πολυθρέμμων
Νεῖλος	noun	Νεῖλος
ἔπεμψεν	verb	πέμπω
·	SENT	:
Σουσισκάνης	noun	Σουσισκάνης
,	SENT	,
Πηγασταγὼν	noun	Πηγασταγών
Αἰγυπτογενής	adjective	Αἰγυπτογενής
,	SENT	,
ὅ	pronoun	/ὅ/ὅστις/ὁς/ὅς/ὁ
τε	particle	τε/??/οὔτε
τῆς	article	ὁ
ἱερᾶς	adjective	ἱερός/ἱερεύς
Μέμφιδος	noun	Μέμφις
ἄρχων	noun	ἄρχων
μέγας	adjective	μέγας
Ἀρσάμης	noun	Αρσάμης/Ἀρσάμης
,	SENT	,
τάς	article	ὁ
τ̓	adjective	<unknown>
ὠγυγίους	adjective	̓ὠγύγιος/ὠγύγιος
Θήβας	noun	Θῆβαι/Θήβη
ἐφέπων	verb	ἐφέπω
Ἀριόμαρδος	noun	Ἀριόμαρδος
,	SENT	,
καὶ	conjunction	???/καί
ἑλειοβάται	adjective	ἑλειοβάτης
ναῶν	noun	ναῦς/ναός
ἐρέται	noun	ἐρέτης
δεινοὶ	adjective	δεινός
πλῆθός	noun	πλῆθος
τ̓	verb	<unknown>
ἀνάριθμοι	adjective	ἀνάριθμος
.	SENT	.
ἁβροδιαίτων	adjective	ἁβροδίαιτος
δ̓	adjective	<unknown>
ἕπεται	verb	ἕπομαι
Λυδῶν	noun	Λυδός
ὄχλος	noun	ὄχλος
,	SENT	,
οἵ	pronoun	ὁ/ὅς/ἕ
τ̓	verb	<unknown>
ἐπίπαν	adverb	ἐπίπαν
ἠπειρογενὲς	adjective	ἠπειρογενής
κατέχουσιν	verb	κατέχω
ἔθνος	noun	ἔθνος
,	SENT	,
τοὺς	article	ὁ
Μητρογαθὴς	noun	Μητρογαθής
Ἀρκτεύς	noun	Ἀρκτεύς
τ̓	verb	<unknown>
ἀγαθός	adjective	ἀγαθός
,	SENT	,
βασιλῆς	noun	βασιλεύς
δίοποι	noun	δίοπος
,	SENT	,
καὶ	conjunction	???/καί
πολύχρυσοι	adjective	πολύχρυσος
Σάρδεις	noun	Σάρδεις
ἐπόχους	adjective	ἔποχος
πολλοῖς	adjective	πολύς
ἅρμασιν	noun	ἅρμα
ἐξορμῶσιν	verb	ἐξορμέω/ἐξορμάω
,	SENT	,
δίρρυμά	adjective	δίρρυμος
τε	particle	τε/??/οὔτε
καὶ	conjunction	???/καί
τρίρρυμα	adjective	τρίρρυμος
τέλη	noun	τέλος
,	SENT	,
φοβερὰν	adjective	φοβερός
ὄψιν	noun	ὄψις
προσιδέσθαι	verb	προσεῖδον
.	SENT	.
στεῦται	verb	στεῦμαι
δ̓	adjective	<unknown>
ἱεροῦ	noun	ἱερόν
Τμώλου	noun	Τμῶλος
πελάται	noun	πελάτης
ζυγὸν	noun	ζυγός/ζυγόν
ἀμφιβαλεῖν	verb	ἀμφιβάλλω
δούλιον	adjective	δούλιος
Ἑλλάδι	noun	Ἑλλάς/ʽἑλλάς
,	SENT	,
Μάρδων	noun	Μάρδων/Μάρδος
,	SENT	,
Θάρυβις	noun	Θάρυβις
,	SENT	,
λόγχης	noun	λόγχη
ἄκμονες	noun	ἄκμων
,	SENT	,
καὶ	conjunction	???/καί
ἀκοντισταὶ	noun	ἀκοντιστής
Μυσοί	noun	Μυσός
·	SENT	:
Βαβυλὼν	noun	Βαβυλών
δ̓	verb	<unknown>
ἡ	article	ὁ
πολύχρυσος	adjective	πολύχρυσος
πάμμικτον	adjective	πάμμικτος/παμμιγής
ὄχλον	noun	ὄχλος
πέμπει	verb	πέμπω
σύρδην	adverb	σύρδην
,	SENT	,
ναῶν	noun	ναῦς/ναός
τ̓	verb	<unknown>
ἐπόχους	adjective	ἔποχος
καὶ	conjunction	???/καί
τοξουλκῷ	adjective	τοξουλκός
λήματι	noun	λῆμα
πιστούς	adjective	πιστός
·	SENT	:
τὸ	article	ὁ
μαχαιροφόρον	adjective	μαχαιροφόρος
τ̓	verb	<unknown>
ἔθνος	noun	ἔθνος
ἐκ	preposition	ἐκ
πάσης	pronoun	πᾶς
Ἀσίας	noun	Ἀσίας/Ἀσία/̓Ασία
ἕπεται	verb	ἕπομαι
δειναῖς	adjective	δεινός
βασιλέως	noun	βασιλεύς
ὑπὸ	preposition	ὑπό
πομπαῖς	noun	πομπή
.	SENT	.
τοιόνδ̓	verb	<unknown>
ἄνθος	noun	ἄνθος
Περσίδος	noun	Περσίς
αἴας	noun	αἶα
οἴχεται	verb	οἴχομαι
ἀνδρῶν	noun	ἀνήρ
,	SENT	,
οὓς	pronoun	ὁ/ὅς
πέρι	preposition	περί
πᾶσα	pronoun	πᾶς
χθὼν	noun	χθών
Ἀσιῆτις	adjective	Ἀσιᾶτις
θρέψασα	verb	τρέφω
πόθῳ	noun	πόθος
στένεται	verb	στένω
μαλερῷ	adjective	μαλερός
,	SENT	,
τοκέες	noun	τοκεύς
τ̓	adjective	<unknown>
ἄλοχοί	noun	ἄλοχος
θ̓	verb	<unknown>
ἡμερολεγδὸν	adverb	ἡμερολεγδόν
τείνοντα	verb	τείνω
χρόνον	noun	χρόνος
τρομέονται	verb	τρομέω
.	SENT	.
πεπέρακεν	verb	περάω
μὲν	adverb	μέν
ὁ	article	ὁ
περσέπτολις	noun	περσέπολις/περσέπτολις
ἤδη	adverb	ἠδή/ἤδη/ἦδη
βασίλειος	adjective	βασίλειος
στρατὸς	noun	στρατός
εἰς	preposition	εἰς
ἀν	unknown	unknown
-	SENT	-
τίπορον	adjective	ἀντίπορος
γείτονα	noun	γείτων
χώραν	noun	χώρα
,	SENT	,
λινοδέσμῳ	adjective	λινόδεσμος
σχεδίᾳ	noun	σχεδία
πορθ	unknown	unknown
-	SENT	-
μὸν	unknown	unknown
ἀμείψας	verb	ἀμείβω
Ἀθαμαντίδος	adjective	Ἀθαμαντίς
Ἕλλας	noun	Ἕλλη
,	SENT	,
πολύγομφον	adjective	πολύγομφος
ὅδισμα	noun	ὅδισμα
ζυγὸν	noun	ζυγός/ζυγόν
ἀμφιβαλὼν	verb	ἀμφιβάλλω
αὐχένι	noun	αὐχήν
πόντου	noun	ποντός/πόντος
.	SENT	.
πολυάνδρου	adjective	πολύανδρος
δ̓	adjective	<unknown>
Ἀσίας	noun	Ἀσίας/Ἀσία/̓Ασία
θούριος	adjective	θούριος
ἄρχων	noun	ἄρχων
ἐπὶ	preposition	ἐπί
πᾶσαν	pronoun	πᾶς
χθόνα	noun	χθών
ποιμα	unknown	unknown
-	SENT	-
νόριον	noun	ποιμανόριον
θεῖον	adjective	θεῖον/θεῖος
ἐλαύνει	verb	ἐλαύνω
διχόθεν	adverb	διχόθεν
,	SENT	,
πεζονόμον	adjective	πεζονόμος
τ̓	verb	<unknown>
ἔκ	preposition	ἐκ
τε	particle	τε/??/οὔτε
θαλάσσας	noun	θάλασσα
,	SENT	,
ἐχυροῖσι	adjective	ἐχυρός
πεποιθὼς	verb	πείθω
στυφελοῖς	adjective	στυφελός
ἐφέταις	noun	ἐφέτης/ἐφέται
,	SENT	,
χρυ	unknown	unknown
-	SENT	-
σογόνου	adjective	χρυσόγονος
γενεᾶς	noun	γενεά
ἰσόθεος	adjective	ἰσόθεος
φώς	noun	φώς
.	SENT	.
κυάνεον	adjective	κυάνεος
δ̓	adjective	<unknown>
ὄμμασι	noun	ὄμμα
λεύσσων	verb	λεύσσω
φονίου	adjective	φόνιος
δέργμα	noun	δέργμα
δράκοντος	noun	δράκων
,	SENT	,
πολύχειρ	noun	πολύχειρ
καὶ	conjunction	???/καί
πολυναύτας	noun	πολυναύτης
,	SENT	,
Σύριόν	adjective	Σύριος
θ̓	adjective	<unknown>
ἅρμα	noun	ἅρμα
διώκων	verb	διώκω
,	SENT	,
ἐπάγει	verb	ἐπάγω
δουρικλύτοις	noun	δουρικλυτός
ἀν	unknown	unknown
-	SENT	-
δράσι	noun	ἀνήρ
τοξόδαμνον	adjective	τοξόδαμνος
Ἄρη	noun	Ἄρης/῎Αρης
.	SENT	.
δόκιμος	adjective	δόκιμος
δ̓	verb	<unknown>
οὔτις	adjective	οὔτις
ὑποστὰς	verb	ὑφίστημι
μεγάλῳ	adjective	μέγας
ῥεύματι	noun	ῥεῦμα
φωτῶν	noun	φώς
ἐχυροῖς	adjective	ἐχυρός
ἕρκεσιν	noun	ἕρκος
εἴργειν	verb	ἔργω
ἄμαχον	adjective	ἄμαχος
κῦμα	noun	κῦμα
θαλάσσας	noun	θάλασσα
·	SENT	:
ἀπρόσοιστος	adjective	ἀπρόσοιστος
γὰρ	adverb	γάρ
ὁ	article	ὁ
Περσᾶν	noun	Πέρσης/πέρσης
στρατὸς	noun	στρατός
ἀλκίφρων	adjective	ἀλκίφρων
τε	particle	τε/??/οὔτε
λαός	noun	λαός
.	SENT	.
θεόθεν	adverb	θεόθεν
γὰρ	particle	γάρ
κατὰ	preposition	κατά
Μοῖῤ	noun	<unknown>
ἐκράτησεν	verb	κρατέω
τὸ	article	ὁ
παλαι	noun	πάλα
-	SENT	-
όν	adjective	παλαιός
,	SENT	,
ἐπέσκηψε	verb	ἐπισκήπτω
δὲ	particle	μηδέ/δέ/οὐδέ
Πέρσαις	noun	Πέρσης/πέρσης
πολέμους	noun	πολέμος/πολεμός/πόλεμος
πυργοδαΐκτους	adjective	πυργοδάικτος
διέπειν	verb	διέπω
ἱππιοχάρμας	noun	ἱππιοχάρμης
τε	particle	τε/??/οὔτε
κλόνους	noun	κλόνος
πόλεών	noun	πόλις
τ̓	adjective	<unknown>
ἀναστάσεις	noun	ἀνάστασις
.	SENT	.
ἔμαθον	verb	μανθάνω
δ̓	adjective	<unknown>
εὐρυπόροι-	unknown	unknown
ο	adjective	εὐρύπορος
θαλάσσας	noun	θάλασσα
πολιαι-	unknown	unknown
νομένας	verb	πολιαίνομαι
πνεύματι	noun	πνεῦμα
λάβρῳ	adjective	λάβρος
ἐσορᾶν	verb	εἰσοράω
πόντιον	adjective	πόντιος
ἄλσος	noun	ἄλσος
,	SENT	,
πίσυνοι	adjective	πίσυνος
λεπτοδόμοις	adjective	λεπτόδομος
πεί-	unknown	unknown
σμασι	noun	πεῖσμα
λα-	unknown	unknown
οπόροις	adjective	λαοπόρος
τε	particle	τε/??/οὔτε
μαχαναῖς	noun	μηχανή
.	SENT	.
δολόμητιν	noun	δολομήτης
δ̓	adjective	<unknown>
ἀπάταν	noun	ἀπάτη
θεοῦ	noun	θέος/θεός
τίς	pronoun	τις/τίς/τὶς
ἀνὴρ	noun	ἀνήρ
θνατὸς	adjective	θνητός
ἀλύξει	noun	ἄλυξις
;	SENT	;
τίς	pronoun	τις/τίς/τὶς
ὁ	article	ὁ
κραιπνῷ	adjective	κραιπνός
ποδὶ	noun	πούς
πήδη-	unknown	unknown
μα	noun	πήδημα
τόδ̓	verb	<unknown>
εὐπετῶς	adverb	εὐπετής
ἀνᾴσσων	verb	ἀνᾴσσω/ἀναίσσω
;	SENT	;
φιλόφρων	adjective	φιλόφρων
γὰρ	particle	γάρ
παρασαίνει	verb	παρασαίνω
βροτὸν	noun	βροτός
εἰς	preposition	εἰς
ἄρκυας	noun	ἄρκυς
Ἄτα	adjective	ἆτος
,	SENT	,
τόθεν	adverb	τόθεν
οὐκ	adverb	οὐ
ἔστιν	verb	εἰμί#1/εἰμί
ὕπερθέν	preposition	ὕπερθεν
νιν	pronoun	νιν
ἄνατον	adjective	ἄνατος
ἐξαλύξαι	verb	ἐξαλύσκω
.	SENT	.
ταῦτά	pronoun	οὗτος
μοι	pronoun	τις/ἐγώ
μελαγχίτων	noun	μελαγχίτων
φρὴν	noun	φρήν
ἀμύσσεται	verb	ἀμύσσω
φόβῳ	noun	φόβος
,	SENT	,
ὀᾶ	interjection	ὀᾶ
,	SENT	,
Περσικοῦ	adjective	Περσικός/περσικός
στρατεύματος	noun	στράτευμα
τοῦδε	adjective	ὅδε
,	SENT	,
μὴ	adverb	μή/μὴ
πόλις	noun	πόλις/πόόλις
πύθη-	unknown	unknown
ται	verb	πυνθάνομαι/κελαινόομαι/φοβέω/ἐλευθερόω/αὐδάω
κένανδρον	adjective	κένανδρος
μέγ̓	verb	<unknown>
ἄστυ	noun	ἄστυ
Σουσίδος	noun	Σουσίς
,	SENT	,
καὶ	conjunction	???/καί
τὸ	article	ὁ
Κισσίων	noun	Κίσσιοι
πόλισμ̓	noun	<unknown>
ἀντίδουπον	adjective	ἀντίδουπος
ᾄσεται	verb	ἀείδω
,	SENT	,
ὀᾶ	interjection	ὀᾶ
,	SENT	,
τοῦτ̓	verb	<unknown>
ἔπος	noun	ἔπος
γυναικοπλη	unknown	unknown
-	SENT	-
θὴς	adjective	θυμοπληθής/γυναικοπληθής
ὅμιλος	noun	ὅμιλος
ἀπύων	adjective	ἄπυος
,	SENT	,
βυσσίνοις	adjective	βύσσινος
δ̓	verb	<unknown>
ἐν	preposition	ἐν/εἰς
πέπλοις	noun	πεπλος/πέπλος
πέσῃ	verb	πίπτω
λακίς	noun	λακίς
.	SENT	.
πᾶς	pronoun	πᾶς
γὰρ	particle	γάρ
ἱππηλάτας	noun	ἱππηλάτης
καὶ	conjunction	???/καί
πεδοστιβὴς	adjective	πεδοστιβής
λεὼς	noun	λαός
σμῆνος	noun	σμῆνος
ὣς	adverb	ὥς/ὡς
ἐκλέλοιπεν	verb	ἐκλείπω
μελις	unknown	unknown
-	SENT	-
σᾶν	noun	μέλισσα
σὺν	preposition	σύν
ὀρχάμῳ	noun	ὄρχαμος
στρατοῦ	noun	στρατός
,	SENT	,
τὸν	article	ὁ/τὸν
ἀμφίζευκτον	adjective	ἀμφίζευκτος
ἐξαμείψας	verb	ἐξαμείβω
ἀμφοτέρας	pronoun	ἀμφότερος
ἅλιον	adjective	ἅλιος
πρῶνα	noun	πρών
κοινὸν	adjective	κοινός
αἴας	noun	αἶα
.	SENT	.
λέκτρα	noun	λέκτρον
δ̓	adjective	<unknown>
ἀνδρῶν	noun	ἀνήρ
πόθῳ	noun	πόθος
πίμπλαται	verb	πίμπλημι
δακρύμασιν	noun	δάκρυμα
·	SENT	:
Περσίδες	noun	περσίς/Περσίς
δ̓	verb	<unknown>
ἁβροπενθεῖς	adjective	ἁβροπενθής
ἑκά	unknown	unknown
-	SENT	-
στα	adjective	ἕκαστος
πόθῳ	noun	πόθος
φιλάνορι	noun	φιλάνωρ
τὸν	article	ὁ/τὸν
αἰχμάεντα	adjective	αἰχμήεις
θοῦρον	adjective	θοῦρος
εὐνα	unknown	unknown
-	SENT	-
τῆῤ	verb	<unknown>
ἀποπεμψαμένα	verb	ἀποπέμπω
λείπεται	verb	λείπω
μονόζυξ	noun	μονόζυξ
.	SENT	.
ἀλλ̓	verb	<unknown>
ἄγε	adverb	ἄγε
,	SENT	,
Πέρσαι	noun	Πέρσης/πέρσης
,	SENT	,
τόδ̓	noun	<unknown>
ἐνεζόμενοι	verb	ἐνέζομαι
στέγος	noun	στέγος
ἀρχαῖον	adjective	ἀρχαῖος
,	SENT	,
φροντίδα	noun	φροντίς
κεδνὴν	adjective	κεδνός
καὶ	conjunction	???/καί
βαθύβουλον	adjective	βαθύβουλος
θώμεθα	verb	θέω/τίθημι/θάομαι/θάζω
,	SENT	,
χρεία	noun	χρέος/χρεία
δὲ	particle	μηδέ/δέ/οὐδέ
προσήκει	verb	προσήκω
,	SENT	,
πῶς	adverb	πως/πῶς
ἄρα	particle	ἄρα
πράσσει	verb	πράσσω
Ξέρξης	proper	Ξέρξης
βασιλεὺς	noun	βασιλεύς
Δαρειογενής	adjective	Δαρειογενής
,	SENT	,
τὸ	article	ὁ
πατρωνύμιον	adjective	πατρωνύμιος
γένος	noun	γένος
ἡμέτερον	adjective	ἡμέτερος
·	SENT	:
πότερον	adjective	πότερος
τόξου	noun	τόξον
ῥῦμα	noun	ῥῦμα
τὸ	article	ὁ
νικῶν	verb	νικάω
,	SENT	,
ἢ	conjunction	ἤ
δορικράνου	adjective	δορίκρανος
λόγχης	noun	λόγχη
ἰσχὺς	noun	ἰσχύς
κεκράτηκεν	verb	κρατέω
.	SENT	.
ἀλλ̓	verb	<unknown>
ἥδε	pronoun	ὅδε
θεῶν	noun	θέος/θεεός/θέα/θεά/θεός/θεὸς
ἴσον	adjective	ἴσος
ὀφθαλμοῖς	noun	ὀφθαλμός
φάος	noun	φάος
ὁρμᾶται	verb	ὁρμάζω/ὁρμάω
μήτηρ	noun	μήτηρ
βασιλέως	noun	βασιλεύς
,	SENT	,
βασίλεια	noun	βασίλεια#1/βασίλεια/βασίλειον
δ̓	verb	<unknown>
ἐμή	adjective	ἐμός
·	SENT	:
προσπίτνω	verb	προσπίτνω/προσπίπτω
·	SENT	:
καὶ	conjunction	???/καί
προσφθόγγοις	adjective	πρόσφθογγος
δὲ	adverb	δέ/οὐ
χρεὼν	unknown	χρεών
αὐτὴν	pronoun	αὐτός
πάντας	adjective	/πᾶς
μύθοισι	noun	μῦθος
προσαυδᾶν	verb	προσαυδάω
.	SENT	.
ὦ	interjection	ὦ
βαθυζώνων	adjective	βαθύζωνος
ἄνασσα	noun	ἄνασσα
Περσίδων	noun	Περσίς
ὑπερτάτη	adjective	ὑπέρ/ὑπέρτατος
,	SENT	,
μῆτερ	noun	μήτηρ
ἡ	article	ὁ
Ξέρξου	noun	Ξέρξης/ξέρξης
γεραιά	adjective	γεραιός
,	SENT	,
χαῖρε	verb	χαίρω
,	SENT	,
Δαρείου	noun	Δαρεῖος
γύναι	noun	γυνή
·	SENT	:
θεοῦ	noun	θέος/θεός
μὲν	particle	μέν
εὐνάτειρα	noun	εὐνητήρ
Περσῶν	noun	Πέρσης/Ρέρσης/πέρσης
,	SENT	,
θεοῦ	noun	θέος/θεός
δὲ	particle	μηδέ/δέ/οὐδέ
καὶ	conjunction	???/καί
μήτηρ	noun	μήτηρ
ἔφυς	verb	φύω
,	SENT	,
εἴ	conjunction	εἰ
τι	pronoun	τις/τίς/τὶς
μὴ	adverb	μή/μὴ
δαίμων	noun	δαίμων
παλαιὸς	adjective	παλαιός
νῦν	adverb	νῦν#1/νῦν
μεθέστηκε	verb	μεθίστημι
στρατῷ	noun	στρατός
.	SENT	.
ταῦτα	pronoun	οὗτος
δὴ	particle	δή
λιποῦσ̓	adjective	<unknown>
ἱκάνω	verb	ἱκανόω/ἱκάνω
χρυσεοστόλμους	adjective	χρυσεόστολμος
δόμους	noun	δόμος
καὶ	conjunction	???/καί
τὸ	article	ὁ
Δαρείου	proper	Δαρεῖος
τε	particle	τε/??/οὔτε
κἀμὸν	adjective	ἐμός
κοινὸν	adjective	κοινός
εὐνατήριον	noun	εὐνατήριον
.	SENT	.
κἀμὲ	pronoun	ἐγώ
καρδίαν	noun	καρδία
ἀμύσσει	verb	ἀμύσσω
φροντίς	noun	φροντίς
·	SENT	:
ἐς	preposition	εἰς
δ̓	verb	<unknown>
ὑμᾶς	pronoun	σύ/ὑμεῖς
ἐρῶ	verb	λέγω/ἐρῶ/ἐρέω/ἐράομαι/ἐράω
μῦθον	noun	μῦθος
οὐδαμῶς	adverb	οὐδαμῶς/οὐδαμός
ἐμαυτῆς	pronoun	ἐμαυτοῦ
οὖσ̓	verb	<unknown>
ἀδείμαντος	adjective	ἀδείμαντος
,	SENT	,
φίλοι	adjective	φίλος
,	SENT	,
μὴ	adverb	μή/μὴ
μέγας	adjective	μέγας
πλοῦτος	noun	πλοῦτος
κονίσας	verb	κονίω/κονίζω
οὖδας	noun	οὖδας
ἀντρέψῃ	verb	ἀνατρέπω
ποδὶ	noun	πούς
ὄλβον	noun	ὄλβος
,	SENT	,
ὃν	pronoun	ὁ/ὅς
Δαρεῖος	noun	Δαρεῖος/δαρεῖος
ἦρεν	verb	αἴρω/ἀείρω
οὐκ	adverb	οὐ
ἄνευ	preposition	ἄνευ
θεῶν	noun	θέος/θεεός/θέα/θεά/θεός/θεὸς
τινος	adjective	τις
.	SENT	.
ταῦτά	pronoun	οὗτος
μοι	pronoun	τις/ἐγώ
διπλῆ	adjective	διπλόος
μέριμνα	noun	μέριμνα
φραστός	adjective	φραστός/ἄφραστος
ἐστιν	verb	εἰμί#1/εἰμί
ἐν	preposition	ἐν/εἰς
φρεσίν	noun	φρήν
,	SENT	,
μήτε	conjunction	μήτε
χρημάτων	noun	χρῆμα
ἀνάνδρων	adjective	ἄνανδρος
πλῆθος	noun	πλῆθος
ἐν	preposition	ἐν/εἰς
τιμῇ	noun	τιμή
σέβειν	verb	σέβω
μήτ̓	verb	<unknown>
ἀχρημάτοισι	adjective	ἀχρήματος
λάμπειν	verb	λάμπω
φῶς	noun	φάος/φῶς
ὅσον	adjective	ὅσος
σθένος	noun	σθένος
πάρα	verb	πάρειμι/πάρα
.	SENT	.
ἔστι	verb	εἰμί#1/εἰμί
γὰρ	particle	γάρ
πλοῦτός	noun	πλοῦτος
γ̓	verb	<unknown>
ἀμεμφής	adjective	ἀμεμφής/ἄμεμπτος
,	SENT	,
ἀμφὶ	preposition	ἀμφί
δ̓	adjective	<unknown>
ὀφθαλμῷ	noun	ὀφθαλμός
φόβος	noun	φόβος
·	SENT	:
ὄμμα	noun	ὄμμα
γὰρ	particle	γάρ
δόμων	noun	δόμος
νομίζω	verb	νομίζω
δεσπότου	noun	δεσπότης
παρουσίαν	noun	παρουσία
.	SENT	.
πρὸς	preposition	πρός
τάδ̓	verb	<unknown>
ὡς	conjunction	ὥς/ὡς
οὕτως	adverb	οὕτω(ς)/οὕτως
ἐχόντων	verb	ἔχω
τῶνδε	pronoun	ὅδε
,	SENT	,
σύμβουλοι	noun	σύμβουλος
λόγου	noun	λόγος
τοῦδέ	pronoun	ὅδε
μοι	pronoun	τις/ἐγώ
γένεσθε	verb	γίγνομαι
,	SENT	,
Πέρσαι	noun	Πέρσης/πέρσης
,	SENT	,
γηραλέα	adjective	γηραλέος/γηραιός
πιστώματα	noun	πίστωμα
·	SENT	:
πάντα	pronoun	πᾶς
γὰρ	adverb	γάρ
τὰ	article	ὁ/τίς
κέδν̓	noun	<unknown>
ἐν	preposition	ἐν/εἰς
ὑμῖν	pronoun	σύ/ὑμεῖς
ἐστί	verb	εἰμί#1/εἰμί
μοι	pronoun	τις/ἐγώ
βουλεύματα	noun	βούλευμα
.	SENT	.
εὖ	adverb	εὖ
τόδ̓	noun	<unknown>
ἴσθι	verb	εἰμί#1/εἰμί/οἶδα
,	SENT	,
γῆς	noun	Γαῖα/γῆ
ἄνασσα	noun	ἄνασσα
τῆσδε	adjective	ὅδε
,	SENT	,
μή	conjunction	μή
σε	pronoun	σύ
δὶς	adverb	δίς
φράσαι	verb	φράζω
μήτ̓	adjective	<unknown>
ἔπος	noun	ἔπος
μήτ̓	adjective	<unknown>
ἔργον	noun	ἔργον
ὧν	pronoun	ὅς
ἂν	adverb	ἀν/ἄν/ἐάν
δύναμις	noun	δύναμις
ἡγεῖσθαι	verb	ἡγέομαι
θέλῃ	verb	ἐθέλω
·	SENT	:
εὐμενεῖς	adjective	εὐμενής
γὰρ	particle	γάρ
ὄντας	verb	εἰμί#1/εἰμί
ἡμᾶς	pronoun	ἐγώ/ἡμεῖς
τῶνδε	pronoun	ὅδε
συμβούλους	noun	σύμβουλος
καλεῖς	verb	καλέω
.	SENT	.
πολλοῖς	adjective	πολύς
μὲν	particle	μέν
αἰεὶ	adverb	ἀεί
νυκτέροις	adjective	νύκτερος
ὀνείρασιν	noun	ὄνειρος
ξύνειμ̓	verb	<unknown>
,	SENT	,
ἀφ̓	verb	<unknown>
οὗπερ	adverb	οὗπερ
παῖς	noun	παῖς
ἐμὸς	adjective	ἐμός
στείλας	verb	στέλλω
στρατὸν	noun	στρατός
Ἰαόνων	noun	̓ἰάων/Ἰάονες
γῆν	noun	Γαῖα/γῆ
οἴχεται	verb	οἴχομαι
πέρσαι	verb	πέρθω
θέλων	verb	ἐθέλω
·	SENT	:
ἀλλ̓	verb	<unknown>
οὔτι	adverb	οὔτι
πω	particle	πω
τοιόνδ̓	verb	<unknown>
ἐναργὲς	adjective	ἐναργής
εἰδόμην	verb	εἴδομαι/εἶδον
ὡς	conjunction	ὥς/ὡς
τῆς	article	ὁ
πάροιθεν	adverb	πάροιθεϝ/πάροιθε
εὐφρόνης	noun	εὐφρόνη
·	SENT	:
λέξω	verb	λέγω
δέ	particle	δέ/οὐδέ
σοι	pronoun	σοι/σύ
.	SENT	.
ἐδοξάτην	verb	δοκέω
μοι	pronoun	τις/ἐγώ
δύο	adjective	δύο
γυναῖκ̓	verb	<unknown>
εὐείμονε	adjective	εὐείμων
,	SENT	,
ἡ	article	ὁ
μὲν	adverb	μέν
πέπλοισι	noun	πεπλος/πέπλος
Περσικοῖς	adjective	Περσικός
ἠσκημένη	verb	ἀσκέω
,	SENT	,
ἡ	article	ὁ
δ̓	adjective	<unknown>
αὖτε	adverb	αὖτε
Δωρικοῖσιν	adjective	Δωρικός
,	SENT	,
εἰς	preposition	εἰς
ὄψιν	noun	ὄψις
μολεῖν	verb	βλώσκω
,	SENT	,
μεγέθει	noun	μέγεθος
τε	particle	τε/??/οὔτε
τῶν	pronoun	ὁ//ὅς
νῦν	adverb	νῦν#1/νῦν
ἐκπρεπεστάτα	adjective	ἐκπρεπής
πολύ	adjective	πολύς
,	SENT	,
κάλλει	noun	κάλλος
τ̓	adjective	<unknown>
ἀμώμω	noun	ἄμωμον
,	SENT	,
καὶ	conjunction	???/καί
κασιγνήτα	noun	κασιγνήτη
γένους	noun	γένος
ταὐτοῦ	adjective	αὐτός/ταὐτός/ταυτός
·	SENT	:
πάτραν	noun	πάτρη/φράτρα/πάτρα
δ̓	adjective	<unknown>
ἔναιον	verb	ναίω
ἡ	article	ὁ
μὲν	adverb	μέν
Ἑλλάδα	proper	Ἑλλάς
κλήρῳ	noun	κλῆρος
λαχοῦσα	verb	λαγχάνω
γαῖαν	noun	γαῖα
,	SENT	,
ἡ	article	ὁ
δὲ	adverb	δέ/οὐ
βάρβαρον	adjective	βάρβαρος
.	SENT	.
τούτω	adjective	οὗτος
στάσιν	noun	στάσις
τιν̓	verb	<unknown>
,	SENT	,
ὡς	conjunction	ὥς/ὡς
ἐγὼ	pronoun	ἐγώ
̓	verb	<unknown>
δόκουν	verb	δοκἐω/δοκέω
ὁρᾶν	verb	ὁράω
,	SENT	,
τεύχειν	verb	τεύχω
ἐν	preposition	ἐν/εἰς
ἀλλήλαισι	adjective	ἀλλήλων
·	SENT	:
παῖς	noun	παῖς
δ̓	verb	<unknown>
ἐμὸς	pronoun	ἐμός
μαθὼν	verb	μανθάνω
κατεῖχε	verb	κατέχω
κἀπράυνεν	verb	πραύνω
,	SENT	,
ἅρμασιν	noun	ἅρμα
δ̓	verb	<unknown>
ὕπο	preposition	ὑπό
ζεύγνυσιν	verb	ζεύγνυμι
αὐτὼ	adjective	αὐτός
καὶ	conjunction	???/καί
λέπαδν̓	verb	<unknown>
ἐπ̓	verb	<unknown>
αὐχένων	noun	αὐχήν
τίθησι	verb	τίθημι
.	SENT	.
χἠ	article	ὁ
μὲν	adverb	μέν
τῇδ̓	adjective	<unknown>
ἐπυργοῦτο	verb	πυργόω
στολῇ	noun	στολή
ἐν	preposition	ἐν/εἰς
ἡνίαισί	noun	ἡνία
τ̓	adjective	<unknown>
εἶχεν	verb	ἔχω
εὔαρκτον	adjective	εὔαρκτος
στόμα	noun	στόμα
,	SENT	,
ἡ	article	ὁ
δ̓	adjective	<unknown>
ἐσφάδαζε	verb	σφαδάζω
,	SENT	,
καὶ	conjunction	???/καί
χεροῖν	noun	χείρ
ἔντη	noun	ἔντεα
δίφρου	noun	δίφρος
διασπαράσσει	verb	διασπαράσσω
καὶ	conjunction	???/καί
ξυναρπάζει	verb	συναρπάζω
βίᾳ	noun	βία
ἄνευ	preposition	ἄνευ
χαλινῶν	noun	χαλινός
καὶ	conjunction	???/καί
ζυγὸν	noun	ζυγός/ζυγόν
θραύει	verb	θραύω
μέσον	adjective	μέσος
.	SENT	.
πίπτει	verb	πίπτω
δ̓	verb	<unknown>
ἐμὸς	adjective	ἐμός
παῖς	noun	παῖς
,	SENT	,
καὶ	conjunction	???/καί
πατὴρ	noun	πατήρ
παρίσταται	verb	παρίστημι
Δαρεῖος	proper	Δαρεῖος
οἰκτείρων	verb	οἰκτείρω
σφε	pronoun	σφεῖς
·	SENT	:
τὸν	article	ὁ/τὸν
δ̓	adjective	<unknown>
ὅπως	conjunction	ὅπως
ὁρᾷ	verb	ὁράω
Ξέρξης	noun	Ξέρξης/Ξήρξης
,	SENT	,
πέπλους	noun	πεπλος/πέπλος
ῥήγνυσιν	verb	ῥήγνυμι
ἀμφὶ	preposition	ἀμφί
σώματι	noun	σῶμα
.	SENT	.
καὶ	conjunction	???/καί
ταῦτα	pronoun	οὗτος
μὲν	adverb	μέν
δὴ	adverb	δή
νυκτὸς	noun	νύξ
εἰσιδεῖν	verb	εἰσεῖδον/εἶδον/εἰσοράω/εἰσιδέω
λέγω	verb	λέγω
.	SENT	.
ἐπεὶ	conjunction	ἐπεί
δ̓	adjective	<unknown>
ἀνέστην	verb	ἀνίστημι
καὶ	conjunction	???/καί
χεροῖν	noun	χείρ
καλλιρρόου	adjective	καλλίρροος/καλλίρρους
ἔψαυσα	verb	ψαύω
πηγῆς	noun	πηγή
,	SENT	,
σὺν	preposition	σύν
θυηπόλῳ	adjective	θυηπόλος
χερὶ	noun	χείρ
βωμὸν	noun	βωμός
προσέστην	verb	προσίστημι
,	SENT	,
ἀποτρόποισι	adjective	ἀπότροπος
δαίμοσιν	noun	δαίμων
θέλουσα	verb	ἐθέλω
θῦσαι	verb	θύω
πέλανον	noun	πέλανος
,	SENT	,
ὧν	pronoun	ὅς
τέλη	noun	τέλος
τάδε	pronoun	ὅδε
.	SENT	.
ὁρῶ	verb	ὁράω
δὲ	particle	μηδέ/δέ/οὐδέ
φεύγοντ̓	adjective	<unknown>
αἰετὸν	noun	ἀετός
πρὸς	preposition	πρός
ἐσχάραν	noun	ἐσχάρα
Φοίβου	noun	Φοῖβος
·	SENT	:
φόβῳ	noun	φόβος
δ̓	verb	<unknown>
ἄφθογγος	adjective	ἄφθογγος
ἐστάθην	verb	ἵστημι
,	SENT	,
φίλοι	adjective	φίλος
·	SENT	:
μεθύστερον	adjective	μεθύστερος
δὲ	particle	μηδέ/δέ/οὐδέ
κίρκον	noun	κίρκος
εἰσορῶ	verb	εἰσοράω
δρόμῳ	noun	δρόμος
πτεροῖς	noun	πτερόν
ἐφορμαίνοντα	verb	ἐφορμαίνω
καὶ	conjunction	???/καί
χηλαῖς	noun	χηλή
κάρα	noun	κάρα/κάρον
τίλλονθ̓	verb	<unknown>
·	SENT	:
ὁ	article	ὁ
δ̓	adjective	<unknown>
οὐδὲν	pronoun	οὐδείς
ἄλλο	adjective	ἄλλος
γ̓	verb	<unknown>
ἢ	conjunction	ἤ
πτήξας	verb	πτήσσω
δέμας	noun	δέμας
παρεῖχε	verb	παρέχω
.	SENT	.
ταῦτ̓	verb	<unknown>
ἔμοιγε	pronoun	ἐγώ
δείματ̓	verb	<unknown>
εἰσιδεῖν	verb	εἰσεῖδον/εἶδον/εἰσοράω/εἰσιδέω
,	SENT	,
ὑμῖν	pronoun	σύ/ὑμεῖς
δ̓	adjective	<unknown>
ἀκούειν	verb	ἀκούω
.	SENT	.
εὖ	adverb	εὖ
γὰρ	particle	γάρ
ἴστε	verb	οἶδα
,	SENT	,
παῖς	noun	παῖς
ἐμὸς	pronoun	ἐμός
πράξας	verb	πράσσω
μὲν	adverb	μέν
εὖ	adverb	εὖ
θαυμαστὸς	adjective	θαυμαστός
ἂν	adverb	ἀν/ἄν/ἐάν
γένοιτ̓	verb	<unknown>
ἀνήρ	noun	ἀνήρ
,	SENT	,
κακῶς	adverb	κακῶς/κακός
δὲ	particle	μηδέ/δέ/οὐδέ
πράξας	verb	πράσσω
,	SENT	,
οὐχ	adverb	οὐ
ὑπεύθυνος	adjective	ὑπεύθυνος
πόλει	noun	πόλις
,	SENT	,
σωθεὶς	verb	σώζω
δ̓	verb	<unknown>
ὁμοίως	adverb	ὁμοιός/ὁμοίως/ὁμοῖος/ὅμοιος
τῆσδε	pronoun	ὅδε
κοιρανεῖ	verb	κοιρανέω
χθονός	noun	χθών
.	SENT	.
οὔ	adverb	οὔπως/οὔτι/οὔτε/οὐ
σε	pronoun	σύ
βουλόμεσθα	verb	βούλομαι
,	SENT	,
μῆτερ	noun	μήτηρ
,	SENT	,
οὔ	adverb	οὔπως/οὔτι/οὔτε/οὐ
τ̓	verb	<unknown>
ἄγαν	adverb	ἄγαν
φοβεῖν	verb	φοβέω
λόγοις	noun	λόγος
οὔ	adverb	οὔπως/οὔτι/οὔτε/οὐ
τε	adverb	τε/οὔτε
θαρσύνειν	verb	θαρσύνω
.	SENT	.
θεοὺς	noun	θεός
δὲ	particle	μηδέ/δέ/οὐδέ
προστροπαῖς	noun	προστροπή
ἱκνουμένη	verb	ἱκνέομαι
,	SENT	,
εἴ	conjunction	εἰ
τι	pronoun	τις/τίς/τὶς
φλαῦρον	adjective	φλαῦρος
εἶδες	verb	εἶδον/ὁράω
,	SENT	,
αἰτοῦ	verb	αἰτέω
τῶνδ̓	adverb	<unknown>
ἀποτροπὴν	noun	ἀποτροπή
τελεῖν	verb	τελέω/τέλλω
,	SENT	,
τὰ	article	ὁ/τίς
δ̓	adjective	<unknown>
ἀγάθ̓	verb	<unknown>
ἐκτελῆ	adjective	ἐκτελής
γενέσθαι	verb	γίγνομαι
σοί	pronoun	σύ
τε	adverb	τε/οὔτε
καὶ	conjunction	???/καί
τέκνοις	noun	τέκνον
σέθεν	pronoun	σύ
καὶ	conjunction	???/καί
πόλει	noun	πόλις
φίλοις	adjective	φίλος
τε	particle	τε/??/οὔτε
πᾶσι	adjective	πα~ς/πᾶς
.	SENT	.
δεύτερον	adjective	δεύτερος
δὲ	particle	μηδέ/δέ/οὐδέ
χρὴ	verb	χρή/χρὴ
χοὰς	noun	χοή
Γῇ	noun	γῆ
τε	conjunction	τε/ὅτε
καὶ	conjunction	???/καί
φθιτοῖς	adjective	φθιτός
χέασθαι	verb	χέω
·	SENT	:
πρευμενῶς	adverb	πρευμενής
δ̓	adjective	<unknown>
αἰτοῦ	verb	αἰτέω
τάδε	pronoun	ὅδε
,	SENT	,
σὸν	adjective	σός
πόσιν	noun	πόσις/πούς
Δαρεῖον	noun	Δαρεῖος/δαρεῖος
,	SENT	,
ὅνπερ	pronoun	ὅς
φὴς	verb	φημί
ἰδεῖν	verb	ἰδέω/εἶδον/ὁράω
κατ̓	verb	<unknown>
εὐφρόνην	noun	εὐφρόνη
,	SENT	,
ἐσθλά	adjective	ἐσθλός
σοι	pronoun	σοι/σύ
πέμπειν	verb	πέμπω
τέκνῳ	noun	τέκνον
τε	particle	τε/??/οὔτε
γῆς	noun	Γαῖα/γῆ
ἔνερθεν	adverb	ἔνερθε
ἐς	preposition	εἰς
φάος	noun	φάος
,	SENT	,
τἄμπαλιν	adverb	ἔμπαλιν
δὲ	particle	μηδέ/δέ/οὐδέ
τῶνδε	pronoun	ὅδε
γαίᾳ	noun	γαῖα
κάτοχα	adjective	κάτοχος
μαυροῦσθαι	verb	μαυρόω
σκότῳ	noun	σκότος
.	SENT	.
ταῦτα	pronoun	οὗτος
θυμόμαντις	noun	θυμόμαντις
ὤν	verb	εἰμί#1/εἰμί
σοι	pronoun	σοι/σύ
πρευμενῶς	adverb	πρευμενής
παρῄνεσα	verb	παραινέω
.	SENT	.
εὖ	adverb	εὖ
δὲ	particle	μηδέ/δέ/οὐδέ
πανταχῇ	adverb	πανταχῇ/πανταχῆ
τελεῖν	verb	τελέω/τέλλω
σοι	pronoun	σοι/σύ
τῶνδε	pronoun	ὅδε
κρίνομεν	verb	κρίνω
πέρι	preposition	περί
.	SENT	.
ἀλλὰ	conjunction	ἀλλά/ἀλλὰ
μὴν	particle	μήν
εὔνους	adjective	εὔνους
γ̓	verb	<unknown>
ὁ	article	ὁ
πρῶτος	adjective	πρότερος/πρῶτος
τῶνδ̓	adverb	<unknown>
ἐνυπνίων	adjective	ἐνύπνιος
κριτὴς	noun	κριτής
παιδὶ	noun	παῖς
καὶ	conjunction	???/καί
δόμοις	noun	δόμος
ἐμοῖσι	adjective	ἐμός
τήνδ̓	verb	<unknown>
ἐκύρωσας	verb	κυρόω
φάτιν	noun	φάτις
.	SENT	.
ἐκτελοῖτο	verb	ἐκτελέω
δὴ	adverb	δή
τὰ	article	ὁ/τίς
χρηστά	adjective	χρηστός
·	SENT	:
ταῦτα	pronoun	οὗτος
δ̓	verb	<unknown>
,	SENT	,
ὡς	conjunction	ὥς/ὡς
ἐφίεσαι	verb	ἐφίημι
,	SENT	,
πάντα	pronoun	πᾶς
θήσομεν	verb	τίθημι
θεοῖσι	noun	θέος/θεός
τοῖς	article	ὁ
τ̓	noun	<unknown>
ἔνερθε	preposition	ἔνερθε
γῆς	noun	Γαῖα/γῆ
φίλοις	adjective	φίλος
,	SENT	,
εὖτ̓	verb	<unknown>
ἂν	particle	ἄν
εἰς	preposition	εἰς
οἴκους	noun	οἶκος
μόλωμεν	verb	βλώσκω
.	SENT	.
κεῖνα	pronoun	ἐκεῖνος/κεῖνος
δ̓	adjective	<unknown>
ἐκμαθεῖν	verb	ἐκμανθάνω
θέλω	verb	ἐθέλω
,	SENT	,
ὦ	interjection	ὦ
φίλοι	adjective	φίλος
,	SENT	,
ποῦ	adverb	ποῦ/πού
τὰς	article	ὁ
Ἀθήνας	proper	Ἀθῆναι/Ἀθήνευς/Ἀθήνη
φασὶν	verb	φημί
ἱδρῦσθαι	verb	ἱδρύω
χθονός	noun	χθών
.	SENT	.
τῆλε	adverb	τῆλε
πρὸς	preposition	πρός
δυσμαῖς	noun	δυσμή
ἄνακτος	noun	ἄναξ
Ἡλίου	noun	ἥλιος/Ἥλιος
φθινασμάτων	noun	φθίνασμα
.	SENT	.
ἀλλὰ	conjunction	ἀλλά/ἀλλὰ
μὴν	particle	μήν
ἵμειῤ	verb	<unknown>
ἐμὸς	adjective	ἐμός
παῖς	noun	παῖς
τήνδε	pronoun	ὅδε
θηρᾶσαι	verb	θηράω
πόλιν	noun	πόλις
;	SENT	;
πᾶσα	pronoun	πᾶς
γὰρ	particle	γάρ
γένοιτ̓	verb	<unknown>
ἂν	adverb	ἀν/ἄν/ἐάν
Ἑλλὰς	noun	Ἑλλάς
βασιλέως	noun	βασιλεύς
ὑπήκοος	adjective	ὑπήκους/ὑπήκοος
.	SENT	.
ὧδέ	adverb	ὧδε
τις	pronoun	τις/τίς/τὶς
πάρεστιν	verb	πάρειμι/πάρειμι#1
αὐτοῖς	pronoun	αὐτός
ἀνδροπλήθεια	noun	ἀνδροπλήθεια
στρατοῦ	noun	στρατός
;	SENT	;
καὶ	conjunction	???/καί
στρατὸς	noun	στρατός
τοιοῦτος	adjective	τοιοῦτος
,	SENT	,
ἔρξας	verb	ἔρδω/ἔργω
πολλὰ	adjective	πολύς
δὴ	adverb	δή
Μήδους	noun	Μῆδος
κακά	adjective	κακός
.	SENT	.
καὶ	conjunction	???/καί
τί	pronoun	τις/τίς/τὶς
πρὸς	preposition	πρός
τούτοισιν	adjective	οὗτος
ἄλλο	adjective	ἄλλος
;	SENT	;
πλοῦτος	noun	πλοῦτος
ἐξαρκὴς	adjective	ἐξαρκής
δόμοις	noun	δόμος
;	SENT	;
ἀργύρου	noun	ἄργυρος
πηγή	noun	πηγή
τις	pronoun	τις/τίς/τὶς
αὐτοῖς	pronoun	αὐτός
ἐστι	verb	εἰμί#1/εἰμί
,	SENT	,
θησαυρὸς	noun	θησαυρός
χθονός	noun	χθών
.	SENT	.
πότερα	adjective	πότερος
γὰρ	particle	γάρ
τοξουλκὸς	adjective	τοξουλκός
αἰχμὴ	noun	αἰχμή
διὰ	preposition	διά
χεροῖν	noun	χείρ
αὐτοῖς	pronoun	αὐτός
πρέπει	verb	πρέπω
;	SENT	;
οὐδαμῶς	adverb	οὐδαμῶς/οὐδαμός
·	SENT	:
ἔγχη	noun	ἔγχος
σταδαῖα	adjective	σταδαῖος
καὶ	conjunction	???/καί
φεράσπιδες	noun	φέρασπις
σαγαί	noun	σαγή
.	SENT	.
τίς	pronoun	τις/τίς/τὶς
δὲ	particle	μηδέ/δέ/οὐδέ
ποιμάνωρ	noun	ποιμάνωρ
ἔπεστι	verb	ἔπειμι#1/ἔπειμι
κἀπιδεσπόζει	verb	ἐπιδεσπόζω
στρατῷ	noun	στρατός
;	SENT	;
οὔτινος	adjective	οὔτις
δοῦλοι	noun	δοῦλος
κέκληνται	verb	καλέω
φωτὸς	noun	φῶς/φώς
οὐ	adverb	οὐκ/οὔπως/οὐ
δ̓	verb	<unknown>
ὑπήκοοι	adjective	ὑπήκους/ὑπήκοος
.	SENT	.
πῶς	adverb	πως/πῶς
ἂν	particle	ἄν
οὖν	adverb	οὖν
μένοιεν	verb	μένω
ἄνδρας	noun	ἀνήρ
πολεμίους	adjective	πολέμιος
ἐπήλυδας	noun	ἔπηλυς
;	SENT	;
ὥστε	conjunction	ὥστε
Δαρείου	noun	Δαρεῖος
πολύν	adjective	πολύς
τε	conjunction	τε/ὅτε
καὶ	conjunction	???/καί
καλὸν	adjective	καλός
φθεῖραι	verb	φθείρω
στρατόν	noun	στρατός
.	SENT	.
δεινά	adjective	δεινός
τοι	particle	τοι
λέγεις	verb	λέγω
ἰόντων	verb	εἰμί/εἶμι
τοῖς	article	ὁ
τεκοῦσι	verb	τίκτω
φροντίσαι	verb	φροντίζω
.	SENT	.
ἀλλ̓	verb	<unknown>
ἐμοὶ	pronoun	ἐμός/ἐγώ
δοκεῖν	verb	δοκέω
τάχ̓	adjective	<unknown>
εἴσῃ	verb	εἴδομαι/εἰσίημι/εἶμι/οἶδα
πάντα	pronoun	πᾶς
νημερτῆ	adjective	νημερτής
λόγον	noun	λόγος
.	SENT	.
τοῦδε	pronoun	ὅδε
γὰρ	particle	γάρ
δράμημα	noun	δράμημα
φωτὸς	noun	φῶς/φώς
Περσικὸν	adjective	Περσικός
πρέπει	verb	πρέπω
μαθεῖν	verb	μανθάνω
,	SENT	,
καὶ	conjunction	???/καί
φέρει	verb	φέρω
σαφές	adjective	σαφής
τι	pronoun	τις/τίς/τὶς
πρᾶγος	noun	πρᾶγος
ἐσθλὸν	adjective	ἐσθλός
ἢ	conjunction	ἤ
κακὸν	adjective	κακός
κλύειν	verb	κλύω
.	SENT	.
ὦ	interjection	ὦ
γῆς	noun	Γαῖα/γῆ
ἁπάσης	adjective	ἅπας
Ἀσιάδος	noun	Ἀσιάς
πολίσματα	noun	πόλισμα
,	SENT	,
ὦ	interjection	ὦ
Περσὶς	noun	Περσίς
αἶα	noun	γαῖα/αἶα
καὶ	conjunction	???/καί
πολὺς	adjective	πολύς
πλούτου	noun	πλοῦτος
λιμήν	noun	λιμήν
,	SENT	,
ὡς	conjunction	ὥς/ὡς
ἐν	preposition	ἐν/εἰς
μιᾷ	adjective	εἷς
πληγῇ	noun	πληγή
κατέφθαρται	verb	καταφθείρω
πολὺς	adjective	πολύς
ὄλβος	noun	ὄλβος
,	SENT	,
τὸ	article	ὁ
Περσῶν	noun	Πέρσης/Ρέρσης/πέρσης
δ̓	verb	<unknown>
ἄνθος	noun	ἄνθος
οἴχεται	verb	οἴχομαι
πεσόν	verb	πίπτω
.	SENT	.
ὤμοι	interjection	ὤμοι
,	SENT	,
κακὸν	adjective	κακός
μὲν	particle	μέν
πρῶτον	adjective	πρότερος/πρῶτος
ἀγγέλλειν	verb	ἀγγέλλω
κακά	adjective	κακός
·	SENT	:
ὅμως	adverb	ὅμως
δ̓	adjective	<unknown>
ἀνάγκη	noun	ἀνάγκη
πᾶν	adjective	πᾶς
ἀναπτύξαι	verb	ἀναπτύσσω
πάθος	noun	πάθος
,	SENT	,
Πέρσαι	noun	Πέρσης/πέρσης
·	SENT	:
στρατὸς	noun	στρατός
γὰρ	particle	γάρ
πᾶς	pronoun	πᾶς
ὄλωλε	verb	ὄλλυμι
βαρβάρων	noun	βάρβαρος
.	SENT	.
ἄνἰ	verb	<unknown>
ἄνια	adjective	ἄνιος
κακὰ	adjective	κακός
νεόκοτα	adjective	νεόκοτος
καὶ	conjunction	???/καί
δάἰ	verb	<unknown>
·.	SENT	·.
αἰαῖ	interjection	αἰαῖ
,	SENT	,
διαίνεσθε	verb	διαίνω
,	SENT	,
Πέρσαι	noun	Πέρσης/πέρσης
,	SENT	,
τόδ̓	noun	<unknown>
ἄχος	noun	ἄχος
κλύοντες	verb	κλύω
.	SENT	.
ὡς	conjunction	ὥς/ὡς
πάντα	pronoun	πᾶς
γ̓	verb	<unknown>
ἔστ̓	verb	<unknown>
ἐκεῖνα	pronoun	ἐκεῖνος
διαπεπραγμένα	verb	διαπράσσω
·	SENT	:
αὐτὸς	pronoun	αὐτός
δ̓	verb	<unknown>
ἀέλπτως	adverb	ἄελπτος
νόστιμον	adjective	νόστιμος
βλέπω	verb	βλέπω
φάος	noun	φάος
.	SENT	.
ἦ	adverb	ἦ/ἦ#2
μακροβίοτος	adjective	μακροβίοτος
ὅδε	pronoun	ὅδε
γέ	particle	γε
τις	pronoun	τις/τίς/τὶς
αἰὼν	noun	αἰών
ἐφάνθη	verb	φαίνω
γεραιοῖς	adjective	γεραιός
,	SENT	,
ἀκούειν	verb	ἀκούω
τόδε	pronoun	ὅδε
πῆμ̓	verb	<unknown>
ἄελπτον	adjective	ἄελπτος
.	SENT	.
καὶ	conjunction	???/καί
μὴν	particle	μήν
παρών	verb	πάρειμι
γε	adverb	γε
κοὐ	adverb	οὐ
λόγους	noun	λογός/λόγος
ἄλλων	adjective	ἄλλος
κλύων	verb	κλύω
,	SENT	,
Πέρσαι	noun	Πέρσης/πέρσης
,	SENT	,
φράσαιμ̓	verb	<unknown>
ἂν	particle	ἄν
οἷ̓	adjective	<unknown>
ἐπορσύνθη	verb	πορσύνω
κακά	adjective	κακός
.	SENT	.
ὀτοτοτοῖ	interjection	ὀτοτοῖ
,	SENT	,
μάταν	adverb	μάτην
τὰ	article	ὁ/τίς
πολλὰ	adjective	πολύς
βέλεα	noun	βέλος
παμμιγῆ	adjective	παμμιγής
γᾶς	noun	γῆ
ἀπ̓	verb	<unknown>
Ἀσίδος	adjective	Ἀσίς
ἦλθε	verb	ἔρχομαι
δᾴ	unknown	unknown
-	SENT	-
αν	adjective	δάιος/πατρῷος
ἐφ̓	verb	<unknown>
Ἑλλάδα	proper	Ἑλλάς
χώραν	noun	χώρα
.	SENT	.
πλήθουσι	verb	πλήθω
νεκρῶν	adjective	νεκρός
δυσπότμως	adverb	δύσποτμος
ἐφθαρμένων	verb	φθείρω
Σαλαμῖνος	noun	Σαλαμίς/σαλαμίς
ἀκταὶ	noun	ἀκτή
πᾶς	adjective	πᾶς
τε	particle	τε/??/οὔτε
πρόσχωρος	adjective	πρόσχωρος
τόπος	noun	τόπος
.	SENT	.
ὀτοτοτοῖ	interjection	ὀτοτοῖ
,	SENT	,
φίλων	adjective	φίλος
ἁλίδονα	adjective	ἁλίδονος
μέλεα	noun	μέλος
πολυβαφῆ	adjective	πολυβαφής
κατθανόντα	verb	καταθνήσκω
λέγεις	verb	λέγω
φέρε	verb	φέρω
-	SENT	-
σθαι	verb	φέρω/ἕπομαι
πλάγκτ̓	verb	<unknown>
ἐν	preposition	ἐν/εἰς
διπλάκεσσιν	noun	δίπλαξ
.	SENT	.
οὐδὲν	pronoun	οὐδείς
γὰρ	particle	γάρ
ἤρκει	verb	αἴρω/ἀρκέω
τόξα	noun	τόξον
,	SENT	,
πᾶς	pronoun	πᾶς
δ̓	adjective	<unknown>
ἀπώλλυτο	verb	ἀπόλλυμι
στρατὸς	noun	στρατός
δαμασθεὶς	verb	δαμάζω
ναΐοισιν	adjective	νήιος
ἐμβολαῖς	noun	ἐμβολή
ἴυζ̓	adjective	<unknown>
ἄποτμον	adjective	ἄποτμος
Πέρσαις	noun	Πέρσης/πέρσης
δυσαιανῆ	adjective	δυσαιανής
βοὰν	noun	βοή
δᾴοις	verb	δαίω
,	SENT	,
ὡς	conjunction	ὥς/ὡς
πάντα	pronoun	πᾶς
παγκάκως	adverb	πάγκακος
ἔφθισαν	verb	φθίω
·	SENT	:
αἰαῖ	interjection	αἰαῖ
στρατοῦ	noun	στρατός
φθαρέντος	verb	φθείρω
.	SENT	.
ὦ	interjection	ὦ
πλεῖστον	adjective	πλεῖστος/πολύς
ἔχθος	noun	ἔχθος
ὄνομα	noun	ὄνομα
Σαλαμῖνος	noun	Σαλαμίς/σαλαμίς
κλύειν	verb	κλύω
.	SENT	.
φεῦ	interjection	φεῦ
,	SENT	,
τῶν	article	ὁ/ὅς
Ἀθηνῶν	noun	̓ἀθῆναι/Ἀθῆναι
ὡς	conjunction	ὥς/ὡς
στένω	verb	στένω/στενόω
μεμνημένος	verb	μιμνῄσκω/μιμνήσκω
.	SENT	.
στυγναί	adjective	στυγνός
γ̓	adjective	<unknown>
Ἀθᾶναι	noun	Ἀθῆναι
δᾴοις	verb	δαίω
·	SENT	:
μεμνῆσθαί	verb	μιμνήσκω
τοι	particle	τοι
πάρα	verb	πάρειμι/πάρα
ὡς	conjunction	ὥς/ὡς
πολλὰς	adjective	πολύς
Περσίδων	noun	Περσίς
μάταν	adverb	μάτην
ἔκτισαν	verb	κτίζω/ἐκτίνω
εὔνιδας	noun	εὖνις
ἠδ̓	verb	<unknown>
ἀνάνδρους	adjective	ἄνανδρος
.	SENT	.
σιγῶ	verb	σιγάω/σιγάζω
πάλαι	adverb	πάλαι
δύστηνος	adjective	δύστηνος
ἐκπεπληγμένη	verb	ἐκπλήσσω/ἐκπλήγνυμι
κακοῖς	adjective	κακός
·	SENT	:
ὑπερβάλλει	verb	ὑπερβάλλω
γὰρ	particle	γάρ
ἥδε	pronoun	ὅδε
συμφορὰ	noun	συμφορά
τὸ	article	ὁ
μήτε	adverb	μήτε
λέξαι	verb	λέγω
μήτ̓	adjective	<unknown>
ἐρωτῆσαι	verb	ἐρωτάω
πάθη	noun	πάθη/πάθος
.	SENT	.
ὅμως	adverb	ὅμως
δ̓	adjective	<unknown>
ἀνάγκη	noun	ἀνάγκη
πημονὰς	noun	πημονή
βροτοῖς	noun	βροτός
φέρειν	verb	φέρω
θεῶν	noun	θέος/θεεός/θέα/θεά/θεός/θεὸς
διδόντων	verb	δίδωμι
·	SENT	:
πᾶν	pronoun	πᾶς
δ̓	adjective	<unknown>
ἀναπτύξας	verb	ἀναπτύσσω
πάθος	noun	πάθος
λέξον	verb	λέγω
καταστάς	verb	καθίστημι
,	SENT	,
κεἰ	conjunction	εἰ
στένεις	verb	στένω
κακοῖς	adjective	κακός
ὅμως	adverb	ὅμως
.	SENT	.
τίς	pronoun	τις/τίς/τὶς
οὐ	adverb	οὐκ/οὔπως/οὐ
τέθνηκε	verb	θνῄσκω/θνήσκω
,	SENT	,
τίνα	pronoun	ὁς/τις/τίς
δὲ	particle	μηδέ/δέ/οὐδέ
καὶ	conjunction	???/καί
πενθήσομεν	verb	πενθέω
τῶν	article	ὁ/ὅς
ἀρχελείων	adjective	ἀρχέλαος
,	SENT	,
ὅστ̓	adjective	<unknown>
ἐπὶ	preposition	ἐπί
σκηπτουχίᾳ	noun	σκηπτουχία
ταχθεὶς	verb	τάσσω
ἄνανδρον	adjective	ἄνανδρος
τάξιν	noun	τάξις
ἠρήμου	verb	ἐρημόω
θανών	verb	θνήσκω
;	SENT	;
Ξέρξης	noun	Ξέρξης/Ξήρξης
μὲν	particle	μέν
αὐτὸς	pronoun	αὐτός
ζῇ	verb	ζῶ/ζάω/ζέω
τε	conjunction	τε/ὅτε
καὶ	conjunction	???/καί
βλέπει	verb	βλέπω
φάος	noun	φάος
.	SENT	.
ἐμοῖς	adjective	ἐμός
μὲν	particle	μέν
εἶπας	verb	λέγω/εἶπον
δώμασιν	noun	δῶμα
φάος	noun	φάος
μέγα	adjective	μέγας
καὶ	conjunction	???/καί
λευκὸν	adjective	λευκός
ἦμαρ	noun	ἦμαρ
νυκτὸς	noun	νύξ
ἐκ	preposition	ἐκ
μελαγχίμου	adjective	μελάγχιμος
.	SENT	.
Ἀρτεμβάρης	noun	Ἀρτεμβάρας/Ἀρτεμβάρης
δὲ	particle	μηδέ/δέ/οὐδέ
μυρίας	adjective	μυρίος
ἵππου	noun	ἵππος
βραβεὺς	noun	βραβεύς
στύφλους	adjective	στύφλος/στυφελός
παῤ	verb	<unknown>
ἀκτὰς	noun	ἀκτή
θείνεται	verb	θείνω
Σιληνιῶν	noun	Σιληνίαι
.	SENT	.
χὠ	article	ὁ
χιλίαρχος	noun	χιλίαρχος
Δαδάκης	noun	Δαδάκης
πληγῇ	noun	πληγή
δορὸς	noun	δόρυ
πήδημα	noun	πήδημα
κοῦφον	adjective	κοῦφος
ἐκ	preposition	ἐκ
νεὼς	noun	ναῦς/νεώς/ναός
ἀφήλατο	verb	ἀφ́αλλομαι/ἀπάλλομαι
·	SENT	:
Τενάγων	noun	Τενάγων
τ̓	adjective	<unknown>
ἀριστεὺς	noun	ἀριστεύς
Βακτρίων	adjective	Βάκτριος
ἰθαιγενὴς	adjective	ἰθαγενής
θαλασσόπληκτον	adjective	θαλασσόπληκτος
νῆσον	noun	νῆσος
Αἴαντος	noun	Αἴας/αἴας
πολεῖ	adjective	πολύς
.	SENT	.
Λίλαιος	noun	Λίλαιος
,	SENT	,
Ἀρσάμης	noun	Αρσάμης/Ἀρσάμης
τε	particle	τε/??/οὔτε
κἈργήστης	noun	Ἀργήστης
τρίτος	adjective	τρίτος
,	SENT	,
οἵδ̓	adjective	<unknown>
ἀμφὶ	preposition	ἀμφί
νῆσον	noun	νῆσος
τὴν	article	ὁ
πελειοθρέμμονα	adjective	πελειοθρέμμων
δινούμενοι	verb	δινέω/δινόω/δινεύω
̓	adjective	<unknown>
κύρισσον	verb	κυρίζω/κυρίσσω
ἰσχυρὰν	adjective	ἰσχυρός
χθόνα	noun	χθών
·	SENT	:
πηγαῖς	adjective	πηγός
τε	particle	τε/??/οὔτε
Νείλου	noun	Νεῖλος
γειτονῶν	verb	γειτονέω
Αἰγυπτίου	adjective	Αἰγύπτιος/Αἰγυπτιός
Ἀρκτεύς	noun	Ἀρκτεύς
,	SENT	,
Ἀδεύης	noun	Ἀδεύης
,	SENT	,
καὶ	conjunction	???/καί
φερεσσάκης	adjective	φερεσσακής
τρίτος	adjective	τρίτος
Φαρνοῦχος	noun	Φαρνοῦχος
,	SENT	,
οἵδε	pronoun	ὅδε
ναὸς	noun	ναῦς/ναός
ἐκ	preposition	ἐκ
μιᾶς	adjective	εἷς
πέσον	verb	πίπτω
.	SENT	.
Χρυσεὺς	adjective	Χρυσεύς
Μάταλλος	noun	Μάταλλος
μυριόνταρχος	noun	μυριόνταρχος
θανών	verb	θνήσκω
,	SENT	,
ἵππου	noun	ἵππος
μελαίνης	adjective	μέλας
ἡγεμὼν	noun	ἡγεμών
τρισμυρίας	adjective	τρισμύριοι
,	SENT	,
πυρρὰν	adjective	πυρρός
ζαπληθῆ	adjective	ζαπληθής
δάσκιον	adjective	δάσκιος
γενειάδα	noun	γενειάς
ἔτεγγ̓	verb	<unknown>
,	SENT	,
ἀμείβων	verb	ἀμείβω
χρῶτα	noun	χρώς
πορφυρέᾳ	adjective	πορφύρεος
βαφῇ	noun	βαφή/βαφεύς
.	SENT	.
καὶ	conjunction	???/καί
Μᾶγος	noun	Μᾶγος
Ἄραβος	adjective	Ἄραβος
,	SENT	,
Ἀρτάβης	noun	Ἀρτάβης
τε	particle	τε/??/οὔτε
Βάκτριος	adjective	Βάκτριος
,	SENT	,
σκληρᾶς	adjective	σκληρός
μέτοικος	noun	μέτοικος
γῆς	noun	Γαῖα/γῆ
,	SENT	,
ἐκεῖ	adverb	ἐκεῖ
κατέφθιτο	verb	καταφθίω/καταφθίνω
.	SENT	.
Ἄμιστρις	noun	Ἄμιστρις
Ἀμφιστρεύς	noun	Ἀμιστρεύς
τε	particle	τε/??/οὔτε
πολύπονον	adjective	πολύπονος
δόρυ	noun	δόρυ
νωμῶν	verb	νωμάω
,	SENT	,
ὅ	pronoun	/ὅ/ὅστις/ὁς/ὅς/ὁ
τ̓	verb	<unknown>
ἐσθλὸς	adjective	ἐσθλός
Ἀριόμαρδος	noun	Ἀριόμαρδος
Σάρδεσι	noun	Σάρδεις
πένθος	noun	πένθος
παρασχών	verb	παρέχω
,	SENT	,
Σεισάμης	noun	Σεισάμης
θ̓	verb	<unknown>
ὁ	article	ὁ
Μύσιος	adjective	Μύσιος
,	SENT	,
Θάρυβίς	noun	Θάρυβις
τε	particle	τε/??/οὔτε
πεντήκοντα	adjective	πεντήκοντα
πεντάκις	adverb	πεντάκις
νεῶν	noun	ναῦς/νεώς/ναός/νέα
ταγός	noun	ταγός
,	SENT	,
γένος	noun	γένος
Λυρναῖος	adjective	Λυρναῖος
,	SENT	,
εὐειδὴς	adjective	εὐειδής
ἀνήρ	noun	ἀνήρ
,	SENT	,
κεῖται	verb	κεῖμαι/κέω
θανὼν	verb	θνήσκω
δείλαιος	adjective	δείλαιος
οὐ	adverb	οὐκ/οὔπως/οὐ
μάλ̓	verb	<unknown>
εὐτυχῶς	adverb	εὐτυχής
·	SENT	:
Συέννεσίς	noun	Συέννεσις
τε	particle	τε/??/οὔτε
πρῶτος	adjective	πρότερος/πρῶτος
εἰς	preposition	εἰς
εὐψυχίαν	noun	εὐψυχία
,	SENT	,
Κιλίκων	noun	κίλιξ/Κίλιξ
ἄπαρχος	noun	ἄπαρχος
,	SENT	,
εἷς	adjective	εἷς
ἀνὴρ	noun	ἀνήρ
πλεῖστον	adjective	πλεῖστος/πολύς
πόνον	noun	πόνος
ἐχθροῖς	adjective	ἐχθρός
παρασχών	verb	παρέχω
εὐκλεῶς	adverb	εὐκλεής
ἀπώλετο	verb	ἀπόλλυμι
.	SENT	.
τοσόνδε	pronoun	τοσόσδε
ταγῶν	noun	ταγός
νῦν	adverb	νῦν#1/νῦν
ὑπεμνήσθην	verb	ὑπομνάομαι/ὑπομιμνήσκω
πέρι	preposition	περί
.	SENT	.
πολλῶν	adjective	πολύς
παρόντων	verb	πάρειμι
δ̓	verb	<unknown>
ὀλίγ̓	adjective	<unknown>
ἀπαγγέλλω	verb	ἀπαγγέλλω
κακά	adjective	κακός
.	SENT	.
αἰαῖ	interjection	αἰαῖ
,	SENT	,
κακῶν	adjective	κακός
ὕψιστα	adjective	ὕψιστος
δὴ	adverb	δή
κλύω	verb	κλύω
τάδε	pronoun	ὅδε
,	SENT	,
αἴσχη	noun	αἶσχος
τε	particle	τε/??/οὔτε
Πέρσαις	noun	Πέρσης/πέρσης
καὶ	conjunction	???/καί
λιγέα	adjective	λιγύς
κωκύματα	noun	κώκυμα
.	SENT	.
ἀτὰρ	particle	ἀτάρ
φράσον	verb	φράζω
μοι	pronoun	τις/ἐγώ
τοῦτ̓	verb	<unknown>
ἀναστρέψας	verb	ἀναστρέφω
πάλιν	adverb	πάλιν
·	SENT	:
πόσον	pronoun	πόσος
δὲ	particle	μηδέ/δέ/οὐδέ
πλῆθος	noun	πλῆθος
ἦν	verb	είμί/εἰμί#1/εἰμί/ἠμί
νεῶν	noun	ναῦς/νεώς/ναός/νέα
Ἑλληνίδων	adjective	Ἑλληνίς
,	SENT	,
ὥστ̓	adverb	<unknown>
ἀξιῶσαι	verb	ἀξιόω/ἀξιάω
Περσικῷ	adjective	Περσικός/περσικός
στρατεύματι	noun	στράτευμα
μάχην	noun	μαχή/μάχη
συνάψαι	verb	συνάπτω
ναΐοισιν	adjective	νήιος
ἐμβολαῖς	noun	ἐμβολή
;	SENT	;
πλήθους	noun	πλῆθος
μὲν	particle	μέν
ἂν	particle	ἄν
σάφ̓	adjective	<unknown>
ἴσθ̓	verb	<unknown>
ἕκατι	adverb	ἕκητι
βάρβαρον	adjective	βάρβαρος
ναυσὶν	noun	ναῦς
κρατῆσαι	verb	κρατέω
.	SENT	.
καὶ	conjunction	???/καί
γὰρ	particle	γάρ
Ἕλλησιν	noun	Ἕλλην/῞ἕλλην
μὲν	adverb	μέν
ἦν	verb	είμί/εἰμί#1/εἰμί/ἠμί
ὁ	article	ὁ
πᾶς	adjective	πᾶς
ἀριθμὸς	noun	ἀριθμός
ἐς	preposition	εἰς
τριακάδας	noun	τριακάς
δέκα	adjective	δέκα
ναῶν	noun	ναῦς/ναός
,	SENT	,
δεκὰς	noun	δεκάς
δ̓	adjective	<unknown>
ἦν	verb	είμί/εἰμί#1/εἰμί/ἠμί
τῶνδε	pronoun	ὅδε
χωρὶς	preposition	χωρίς/χωρὶς
ἔκκριτος	adjective	ἔκκριτος
·	SENT	:
Ξέρξῃ	noun	Ξέρξης
δέ	particle	δέ/οὐδέ
,	SENT	,
καὶ	conjunction	???/καί
γὰρ	adverb	γάρ
οἶδα	verb	εἴδω/οἶδα
,	SENT	,
χιλιὰς	noun	χιλιάς
μὲν	particle	μέν
ἦν	verb	είμί/εἰμί#1/εἰμί/ἠμί
ὧν	pronoun	ὅς
ἦγε	verb	ἄγω
πλῆθος	noun	πλῆθος
,	SENT	,
αἱ	article	ὁ
δ̓	adjective	<unknown>
ὑπέρκοποι	adjective	ὑπέρκοπος
τάχει	noun	τάχος
ἑκατὸν	adjective	ἑκατόν
δὶς	adverb	δίς
ἦσαν	verb	εἰμί#1/εἰμί
ἑπτά	adjective	ἑπτά
θ̓	verb	<unknown>
·	SENT	:
ὧδ̓	adverb	<unknown>
ἔχει	verb	ἐχώ/ἔχω/χέω/χάω
λόγος	noun	λόγος
.	SENT	.
μή	conjunction	μή
σοι	pronoun	σοι/σύ
δοκοῦμεν	verb	δοκόω/δοκέω
τῇδε	pronoun	ὅδε
λειφθῆναι	verb	λείπω
μάχῃ	noun	μαχή/μάχη
;	SENT	;
ἀλλ̓	verb	<unknown>
ὧδε	adverb	ὧδε
δαίμων	noun	δαίμων
τις	pronoun	τις/τίς/τὶς
κατέφθειρε	verb	καταφθείρω
στρατόν	noun	στρατός
,	SENT	,
τάλαντα	noun	τάλαντον
βρίσας	verb	βρίθω/βρίζω
οὐκ	adverb	οὐ
ἰσορρόπῳ	adjective	ἰσόρροπος
τύχῃ	noun	τύχη
.	SENT	.
θεοὶ	noun	θεός
πόλιν	noun	πόλις
σῴζουσι	verb	σώζω
Παλλάδος	noun	παλλάς/Παλλάς
θεᾶς	noun	θεά
.	SENT	.
ἔτ̓	verb	<unknown>
ἆῤ	verb	<unknown>
Ἀθηνῶν	noun	̓ἀθῆναι/Ἀθῆναι
ἔστ̓	verb	<unknown>
ἀπόρθητος	adjective	ἀπόρθητος
πόλις	noun	πόλις/πόόλις
;	SENT	;
ἀνδρῶν	noun	ἀνήρ
γὰρ	particle	γάρ
ὄντων	verb	εἰμί#1/εἰμί
ἕρκος	noun	ἕρκος
ἐστὶν	verb	εἰμί#1/εἰμί
ἀσφαλές	adjective	ἀσφαλής
.	SENT	.
ἀρχὴ	noun	ἀρχή
δὲ	particle	μηδέ/δέ/οὐδέ
ναυσὶ	noun	ναῦς
συμβολῆς	noun	συμβολεύς/συμβολή
τίς	pronoun	τις/τίς/τὶς
ἦν	verb	είμί/εἰμί#1/εἰμί/ἠμί
,	SENT	,
φράσον	verb	φράζω
·	SENT	:
τίνες	pronoun	τις/τίς/τ́ις
κατῆρξαν	verb	κατάρχω
,	SENT	,
πότερον	adjective	πότερος
Ἕλληνες	noun	Ἕλλην/῞ἕλλην
,	SENT	,
μάχης	noun	μαχή/μάχη
,	SENT	,
ἢ	conjunction	ἤ
παῖς	noun	παῖς
ἐμός	adjective	ἐμός
,	SENT	,
πλήθει	noun	πλῆθος
καταυχήσας	verb	καταυχέω
νεῶν	noun	ναῦς/νεώς/ναός/νέα
;	SENT	;
ἦρξεν	verb	ἔρδω/ἄρχω
μέν	particle	μέν
,	SENT	,
ὦ	interjection	ὦ
δέσποινα	noun	δέσποινα
,	SENT	,
τοῦ	article	ὁ/ὅς/τὁ/ὀ
παντὸς	adjective	πᾶς
κακοῦ	adjective	κακός/κακός·
φανεὶς	verb	φαίνω
ἀλάστωρ	noun	ἀλάστωρ
ἢ	conjunction	ἤ
κακὸς	adjective	κακός
δαίμων	noun	δαίμων
ποθέν	adverb	ποθεν
.	SENT	.
ἀνὴρ	noun	ἀνήρ
γὰρ	particle	γάρ
Ἕλλην	noun	Ἕλλην
ἐξ	preposition	ἐκ
Ἀθηναίων	noun	Ἀθήναια/Ἀθηναῖος/Ἀθήναιον/Ἀθήναιος
στρατοῦ	noun	στρατός
ἐλθὼν	verb	ἔρχομαι
ἔλεξε	verb	λέγω
παιδὶ	noun	παῖς
σῷ	adjective	σός
Ξέρξῃ	proper	Ξέρξης
τάδε	pronoun	ὅδε
,	SENT	,
ὡς	adverb	ὡς#2/ʽὡς/ὥς/ὡς
εἰ	conjunction	εἰ
μελαίνης	adjective	μέλας
νυκτὸς	noun	νύξ
ἵξεται	verb	ἱκνέομαι/ἵζω
κνέφας	noun	κνέφας
,	SENT	,
Ἕλληνες	noun	Ἕλλην/῞ἕλλην
οὐ	adverb	οὐκ/οὔπως/οὐ
μενοῖεν	verb	μένω
,	SENT	,
ἀλλὰ	conjunction	ἀλλά/ἀλλὰ
σέλμασιν	noun	σέλμα
ναῶν	noun	ναῦς/ναός
ἐπανθορόντες	verb	ἀναθρῴσκω/ἐπαναθρῳσκω
ἄλλος	adjective	ἄλλος
ἄλλοσε	adverb	ἄλλοτε/ἄλλοσε
δρασμῷ	noun	δρασμός
κρυφαίῳ	adjective	κρυφαῖος/κρυπτός
βίοτον	noun	βίοτος
ἐκσωσοίατο	verb	ἐκσῴζω
.	SENT	.
ὁ	article	ὁ
δ̓	adjective	<unknown>
εὐθὺς	adverb	εὐθύς
ὡς	adverb	ὡς#2/ʽὡς/ὥς/ὡς
ἤκουσεν	verb	ἀκούω
,	SENT	,
οὐ	adverb	οὐκ/οὔπως/οὐ
ξυνεὶς	verb	συνίημι
δόλον	noun	δόλος
Ἕλληνος	noun	Ἕλλην
ἀνδρὸς	noun	ἀνήρ
οὐ	adverb	οὐκ/οὔπως/οὐ
δὲ	adverb	δέ/οὐ
τὸν	article	ὁ/τὸν
θεῶν	noun	θέος/θεεός/θέα/θεά/θεός/θεὸς
φθόνον	noun	φθόνος
,	SENT	,
πᾶσιν	pronoun	πᾶς
προφωνεῖ	verb	προφωνέω
τόνδε	pronoun	ὅδε
ναυάρχοις	noun	ναύαρχος
λόγον	noun	λόγος
,	SENT	,
εὖτ̓	verb	<unknown>
ἂν	particle	ἄν
φλέγων	verb	φλέγω
ἀκτῖσιν	noun	ἀκτίς
ἥλιος	noun	ἥλιος
χθόνα	noun	χθών
λήξῃ	verb	λήγω/λαγχάνω
,	SENT	,
κνέφας	noun	κνέφας
δὲ	particle	μηδέ/δέ/οὐδέ
τέμενος	noun	τέμενος
αἰθέρος	noun	αἰθήρ
λάβῃ	verb	λαμβάνω
,	SENT	,
τάξαι	verb	τάσσω
νεῶν	noun	ναῦς/νεώς/ναός/νέα
στῖφος	noun	στῖφος
μὲν	particle	μέν
ἐν	preposition	ἐν/εἰς
στοίχοις	noun	στοῖχος
τρισὶν	adjective	τρεῖς
ἔκπλους	noun	ἔκπλοος
φυλάσσειν	verb	φυλάσσω/φυλάζω
καὶ	conjunction	???/καί
πόρους	noun	πόρος
ἁλιρρόθους	adjective	ἁλίρροθος
,	SENT	,
ἄλλας	adjective	ἄλλος
δὲ	particle	μηδέ/δέ/οὐδέ
κύκλῳ	noun	κύκλος
νῆσον	noun	νῆσος
Αἴαντος	noun	Αἴας/αἴας
πέριξ	adverb	πέριξ
·	SENT	:
ὡς	adverb	ὡς#2/ʽὡς/ὥς/ὡς
εἰ	conjunction	εἰ
μόρον	noun	μόρον/μόρος
φευξοίαθ̓	adjective	<unknown>
Ἕλληνες	noun	Ἕλλην/῞ἕλλην
κακόν	adjective	κακός
,	SENT	,
ναυσὶν	noun	ναῦς
κρυφαίως	adjective	κρυφαῖος
δρασμὸν	noun	δρασμός
εὑρόντες	verb	εὑρίσκω
τινά	pronoun	τις/τὶς
,	SENT	,
πᾶσιν	pronoun	πᾶς
στέρεσθαι	verb	στέρομαι
κρατὸς	noun	κράς
ἦν	verb	είμί/εἰμί#1/εἰμί/ἠμί
προκείμενον	verb	πρόκειμαι
.	SENT	.
τοσαῦτ̓	verb	<unknown>
ἔλεξε	verb	λέγω
κάρθ̓	adjective	<unknown>
ὑπ̓	verb	<unknown>
εὐθύμου	adjective	εὔθυμος
φρενός	noun	πρήν/φρήν
·	SENT	:
οὐ	adverb	οὐκ/οὔπως/οὐ
γὰρ	adverb	γάρ
τὸ	article	ὁ
μέλλον	verb	μέλλω
ἐκ	preposition	ἐκ
θεῶν	noun	θέος/θεεός/θέα/θεά/θεός/θεὸς
ἠπίστατο	verb	ἐπίσταμαι
.	SENT	.
οἱ	pronoun	/οὗ/ὅς/ἕ/ὁ
δ̓	verb	<unknown>
οὐκ	adverb	οὐ
ἀκόσμως	adverb	ἀκόσμως/ἄκοσμος
,	SENT	,
ἀλλὰ	conjunction	ἀλλά/ἀλλὰ
πειθάρχῳ	adjective	πείθαρχος
φρενὶ	noun	πρήν/φρήν
δεῖπνόν	noun	δεῖπνον
τ̓	adjective	<unknown>
ἐπορσύνοντο	verb	πορσύνω
,	SENT	,
ναυβάτης	noun	ναυβάτης
τ̓	adjective	<unknown>
ἀνὴρ	noun	ἀνήρ
τροποῦτο	verb	τροπόω
κώπην	noun	κώπη
σκαλμὸν	noun	σκαλμός
ἀμφ̓	verb	<unknown>
εὐήρετμον	adjective	εὐήρετμος
.	SENT	.
ἐπεὶ	conjunction	ἐπεί
δὲ	adverb	δέ/οὐ
φέγγος	noun	φέγγος
ἡλίου	noun	ἥλιος/ἤλιος
κατέφθιτο	verb	καταφθίω/καταφθίνω
καὶ	conjunction	???/καί
νὺξ	noun	νύξ
ἐπῄει	verb	ἔπειμι
,	SENT	,
πᾶς	pronoun	πᾶς
ἀνὴρ	noun	ἀνήρ
κώπης	verb	κωπάω
ἄναξ	noun	ἄναξ
ἐς	preposition	εἰς
ναῦν	noun	ναῦς
ἐχώρει	verb	χωρέω
πᾶς	pronoun	πᾶς
θ̓	verb	<unknown>
ὅπλων	noun	ὅπλον
ἐπιστάτης	noun	ἐπιστάτη/ἐπιστάτης
·	SENT	:
τάξις	noun	τάξις
δὲ	particle	μηδέ/δέ/οὐδέ
τάξιν	noun	τάξις
παρεκάλει	verb	παρακαλέω
νεὼς	noun	ναῦς/νεώς/ναός
μακρᾶς	adjective	μακρός
·	SENT	:
πλέουσι	verb	πλέω
δ̓	verb	<unknown>
ὡς	conjunction	ὥς/ὡς
ἕκαστος	adjective	ἕκαστος
ἦν	verb	είμί/εἰμί#1/εἰμί/ἠμί
τεταγμένος	verb	τάσσω
,	SENT	,
καὶ	conjunction	???/καί
πάννυχοι	adjective	πάννυχος
δὴ	adverb	δή
διάπλοον	adjective	διάπλοος
καθίστασαν	verb	καθιστάω/καθίστημι
ναῶν	noun	ναῦς/ναός
ἄνακτες	noun	ἄναξ
πάντα	adjective	/πα~ς/πᾶς
ναυτικὸν	adjective	ναυτικός
λεών	noun	λαός
.	SENT	.
καὶ	conjunction	???/καί
νὺξ	noun	νύξ
ἐχώρει	verb	χωρέω
,	SENT	,
κοὐ	adverb	οὐ
μάλ̓	adjective	<unknown>
Ἑλλήνων	noun	Ἕλλην/῞ἕλλην
στρατὸς	noun	στρατός
κρυφαῖον	adjective	κρυφαῖος
ἔκπλουν	verb	ἐκπλέω
οὐδαμῇ	adverb	οὐδαμῇ/οὐδαμός
καθίστατο	verb	καθίστημι
·	SENT	:
ἐπεί	conjunction	ἐπεί
γε	particle	γε
μέντοι	particle	μέντοι
λευκόπωλος	adjective	λευκόπωλος
ἡμέρα	noun	ἡμέρα
πᾶσαν	adjective	πᾶς
κατέσχε	verb	κατέχω
γαῖαν	noun	γαῖα
εὐφεγγὴς	adjective	εὐφεγγής
ἰδεῖν	verb	ἰδέω/εἶδον/ὁράω
,	SENT	,
πρῶτον	adjective	πρότερος/πρῶτος
μὲν	particle	μέν
ἠχῇ	noun	ἠχή
κέλαδος	noun	κέλαδος
Ἑλλήνων	noun	Ἕλλην/῞ἕλλην
πάρα	preposition	παρά
μολπηδὸν	adverb	μολπηδόν
ηὐφήμησεν	verb	εὐφημέω
,	SENT	,
ὄρθιον	adjective	ὄρθιος
δ̓	verb	<unknown>
ἅμα	adverb	ἅμα
ἀντηλάλαξε	verb	ἀνταλαλάζω
νησιώτιδος	noun	νησιώτης
πέτρας	noun	πέτρα
ἠχώ	noun	ἠχώ
·	SENT	:
φόβος	noun	φόβος
δὲ	particle	μηδέ/δέ/οὐδέ
πᾶσι	adjective	πα~ς/πᾶς
βαρβάροις	noun	βάρβαρος
παρῆν	verb	πάρειμι/πάρειμι#1
γνώμης	noun	γνώμη
ἀποσφαλεῖσιν	verb	ἀποσφάλλω
·	SENT	:
οὐ	adverb	οὐκ/οὔπως/οὐ
γὰρ	particle	γάρ
ὡς	adverb	ὡς#2/ʽὡς/ὥς/ὡς
φυγῇ	noun	φυγή
παιᾶν̓	adjective	<unknown>
ἐφύμνουν	verb	ἐφυμνέω
σεμνὸν	adjective	σεμνός
Ἕλληνες	noun	Ἕλλην/῞ἕλλην
τότε	adverb	τότε
,	SENT	,
ἀλλ̓	verb	<unknown>
ἐς	preposition	εἰς
μάχην	noun	μαχή/μάχη
ὁρμῶντες	verb	ὁρμάζω/ὁρμάω
εὐψύχῳ	adjective	εὔψυχος
θράσει	noun	θράσις/θράσος
·	SENT	:
σάλπιγξ	noun	σάλπιγξ
δ̓	adjective	<unknown>
ἀϋτῇ	noun	ἀυτή
πάντ̓	adjective	<unknown>
ἐκεῖν̓	verb	<unknown>
ἐπέφλεγεν	verb	ἐπιφλέγω
.	SENT	.
εὐθὺς	adverb	εὐθύς
δὲ	particle	μηδέ/δέ/οὐδέ
κώπης	noun	κώπη
ῥοθιάδος	noun	ῥοθιάς
ξυνεμβολῇ	noun	συνεμβολή
ἔπαισαν	verb	παίω/ἐπαείδω
ἅλμην	noun	ἅλμη
βρύχιον	adjective	βρύχιος
ἐκ	preposition	ἐκ
κελεύματος	noun	κέλευμα/κέλευθος
,	SENT	,
θοῶς	adverb	θοός
δὲ	particle	μηδέ/δέ/οὐδέ
πάντες	pronoun	πᾶς
ἦσαν	verb	εἰμί#1/εἰμί
ἐκφανεῖς	adverb	ἐκφανής
ἰδεῖν	verb	ἰδέω/εἶδον/ὁράω
.	SENT	.
τὸ	article	ὁ
δεξιὸν	adjective	δεξιός
μὲν	adverb	μέν
πρῶτον	adjective	πρότερος/πρῶτος
εὐτάκτως	adjective	εὔτακτος
κέρας	noun	κέρας
ἡγεῖτο	verb	ἁγέομαι/ἡγέομαι
κόσμῳ	noun	κόσμος
,	SENT	,
δεύτερον	adjective	δεύτερος
δ̓	verb	<unknown>
ὁ	article	ὁ
πᾶς	adjective	πᾶς
στόλος	noun	στόλος
ἐπεξεχώρει	verb	ἐπεκχωρέω
,	SENT	,
καὶ	conjunction	???/καί
παρῆν	verb	πάρειμι/πάρειμι#1
ὁμοῦ	adverb	ὁμοῦ
κλύειν	verb	κλύω
πολλὴν	adjective	πολύς
βοήν	noun	βοή
,	SENT	,
"	SENT	"
ὦ	interjection	ὦ
παῖδες	noun	παίς/παῖς
Ἑλλήνων	noun	Ἕλλην/῞ἕλλην
ἴτε	verb	εἶμι
,	SENT	,
ἐλευθεροῦτε	verb	ἐλευθερόω
πατρίδ̓	verb	<unknown>
,	SENT	,
ἐλευθεροῦτε	verb	ἐλευθερόω
δὲ	particle	μηδέ/δέ/οὐδέ
παῖδας	noun	παῖς
,	SENT	,
γυναῖκας	noun	γυνή
,	SENT	,
θεῶν	noun	θέος/θεεός/θέα/θεά/θεός/θεὸς
τέ	particle	τε
πατρῴων	adjective	πατρῷος
ἕδη	noun	ἕδος
,	SENT	,
θήκας	noun	θήκη
τε	particle	τε/??/οὔτε
προγόνων	noun	πρόγονος
·	SENT	:
νῦν	adverb	νῦν#1/νῦν
ὑπὲρ	preposition	ὑπέρ
πάντων	adjective	πᾶς
ἀγών	noun	ἀγών
.	SENT	.
καὶ	conjunction	???/καί
μὴν	particle	μήν
παῤ	verb	<unknown>
ἡμῶν	pronoun	σύ/ἐγώ/ἡμεῖς
Περσίδος	noun	Περσίς
γλώσσης	noun	γλῶσσα
ῥόθος	noun	ῥόθος
ὑπηντίαζε	verb	ὑπαντιάζω
,	SENT	,
κοὐκέτ̓	verb	<unknown>
ἦν	verb	είμί/εἰμί#1/εἰμί/ἠμί
μέλλειν	verb	μέλλω
ἀκμή	noun	ἀκμή
.	SENT	.
εὐθὺς	adverb	εὐθύς
δὲ	particle	μηδέ/δέ/οὐδέ
ναῦς	noun	ναῦς
ἐν	preposition	ἐν/εἰς
νηὶ	noun	ναῦς
χαλκήρη	adjective	χαλκήρης
στόλον	noun	στόλος
ἔπαισεν	verb	παίω/ἐπαείδω
·	SENT	:
ἦρξε	verb	ἔρδω/ἄρχω
δ̓	adjective	<unknown>
ἐμβολῆς	noun	ἐμβολή/ἐμβολεύς
Ἑλληνικὴ	adjective	Ἑλληνικός
ναῦς	noun	ναῦς
,	SENT	,
κἀποθραύει	verb	ἀποθραύω
πάντα	pronoun	πᾶς
Φοινίσσης	noun	Φοῖνιξ
νεὼς	noun	ναῦς/νεώς/ναός
κόρυμβ̓	verb	<unknown>
,	SENT	,
ἐπ̓	verb	<unknown>
ἄλλην	adjective	ἄλλος
δ̓	verb	<unknown>
ἄλλος	adjective	ἄλλος
ηὔθυνεν	verb	εὐθύνω
δόρυ	noun	δόρυ
.	SENT	.
τὰ	article	ὁ/τίς
πρῶτα	adjective	πρότερος/πρῶτος
μέν	adverb	μέν
νυν	adverb	νῦν#1/νῦν/νυν#2
ῥεῦμα	noun	ῥεῦμα
Περσικοῦ	adjective	Περσικός/περσικός
στρατοῦ	noun	στρατός
ἀντεῖχεν	verb	ἀντέχω
·	SENT	:
ὡς	adverb	ὡς#2/ʽὡς/ὥς/ὡς
δὲ	particle	μηδέ/δέ/οὐδέ
πλῆθος	noun	πλῆθος
ἐν	preposition	ἐν/εἰς
στενῷ	adjective	στενός
νεῶν	noun	ναῦς/νεώς/ναός/νέα
ἤθροιστ̓	verb	<unknown>
ἀρωγὴ	noun	ἀρωγή
δ̓	verb	<unknown>
οὔτις	adjective	οὔτις
ἀλλήλοις	pronoun	ἀλλήλων
παρῆν	verb	πάρειμι/πάρειμι#1
,	SENT	,
αὐτοὶ	pronoun	αὐτός
δ̓	adjective	<unknown>
ὑφ̓	verb	<unknown>
αὑτῶν	pronoun	αὐτός/ἑαυτοῦ
ἐμβόλοις	noun	ἔμβολον/ἔμβολος
χαλκοστόμοις	adjective	χαλκόστομος
παίοντ̓	verb	<unknown>
,	SENT	,
ἔθραυον	verb	θραύω
πάντα	pronoun	πᾶς
κωπήρη	adjective	κωπήρης
στόλον	noun	στόλος
,	SENT	,
Ἑλληνικαί	adjective	Ἑλληνικός
τε	particle	τε/??/οὔτε
νῆες	noun	ναῦς
οὐκ	adverb	οὐ
ἀφρασμόνως	adverb	ἀφράσμων/ἀφράδμων
κύκλῳ	adverb	κύκλῳ
πέριξ	adverb	πέριξ
ἔθεινον	verb	θείνω
,	SENT	,
ὑπτιοῦτο	verb	ὑπτιόω/ὑπτιόομαι
δὲ	particle	μηδέ/δέ/οὐδέ
σκάφη	noun	σκάφη/σκάφος
νεῶν	noun	ναῦς/νεώς/ναός/νέα
,	SENT	,
θάλασσα	noun	θάλασσα
δ̓	verb	<unknown>
οὐκέτ̓	adjective	<unknown>
ἦν	verb	είμί/εἰμί#1/εἰμί/ἠμί
ἰδεῖν	verb	ἰδέω/εἶδον/ὁράω
,	SENT	,
ναυαγίων	noun	ναυάγιον
πλήθουσα	verb	πλήθω
καὶ	conjunction	???/καί
φόνου	noun	φόνος
βροτῶν	noun	βροτός
.	SENT	.
ἀκταὶ	noun	ἀκτή
δὲ	particle	μηδέ/δέ/οὐδέ
νεκρῶν	adjective	νεκρός
χοιράδες	noun	χοιράς
τ̓	adjective	<unknown>
ἐπλήθυον	verb	πληθύω
,	SENT	,
φυγῇ	noun	φυγή
δ̓	verb	<unknown>
ἀκόσμῳ	adjective	ἄκοσμος
πᾶσα	adjective	πᾶς
ναῦς	noun	ναῦς
ἠρέσσετο	verb	ἐρέσσω
,	SENT	,
ὅσαιπερ	adjective	ὅσος
ἦσαν	verb	εἰμί#1/εἰμί
βαρβάρου	adjective	βάρβαρος
στρατεύματος	noun	στράτευμα
.	SENT	.
τοὶ	pronoun	ὁ//σύ/ὅς
δ̓	verb	<unknown>
ὥστε	conjunction	ὥστε
θύννους	noun	θύννος
ἤ	conjunction	ἤ/ἠέ
τιν̓	verb	<unknown>
ἰχθύων	noun	ἰχθύς
βόλον	noun	βόλος
ἀγαῖσι	noun	ἀγή
κωπῶν	verb	κωπέω/κωπάω
θραύμασίν	noun	θραῦμα
τ̓	adjective	<unknown>
ἐρειπίων	noun	ἐρείπιον
ἔπαιον	verb	παίω
,	SENT	,
ἐρράχιζον	verb	ῥαχίζω
·	SENT	:
οἰμωγὴ	noun	οἰμωγή
δ̓	verb	<unknown>
ὁμοῦ	adverb	ὁμοῦ
κωκύμασιν	noun	κώκυμα
κατεῖχε	verb	κατέχω
πελαγίαν	adjective	πελάγιος
ἅλα	noun	ἅλας/ἅλς
,	SENT	,
ἕως	conjunction	ἑώς/ἕως/ἔως
κελαινῆς	adjective	κελαινός
νυκτὸς	noun	νύξ
ὄμμ̓	verb	<unknown>
ἀφείλετο	verb	ἀφαιρέω
.	SENT	.
κακῶν	adjective	κακός
δὲ	particle	μηδέ/δέ/οὐδέ
πλῆθος	noun	πλῆθος
,	SENT	,
οὐ	adverb	οὐκ/οὔπως/οὐ
δ̓	verb	<unknown>
ἂν	adverb	ἀν/ἄν/ἐάν
εἰ	conjunction	εἰ
δέκ̓	verb	<unknown>
ἤματα	noun	ἦμαρ
στοιχηγοροίην	verb	στοιχηγορέω
,	SENT	,
οὐκ	adverb	οὐ
ἂν	particle	ἄν
ἐκπλήσαιμί	verb	ἐκπίμπλημι
σοι	pronoun	σοι/σύ
.	SENT	.
εὖ	adverb	εὖ
γὰρ	particle	γάρ
τόδ̓	noun	<unknown>
ἴσθι	verb	εἰμί#1/εἰμί/οἶδα
,	SENT	,
μηδάμ̓	verb	<unknown>
ἡμέρᾳ	noun	ἡμέρα
μιᾷ	adjective	εἷς
πλῆθος	noun	πλῆθος
τοσουτάριθμον	adjective	τοσουτάριθμος
ἀνθρώπων	noun	ἄνθρωπος
θανεῖν	verb	θνήσκω
.	SENT	.
αἰαῖ	interjection	αἰαῖ
,	SENT	,
κακῶν	adjective	κακός
δὴ	particle	δή
πέλαγος	noun	πέλαγος
ἔρρωγεν	verb	ῥήγνυμι
μέγα	adjective	μέγας
Πέρσαις	noun	Πέρσης/πέρσης
τε	conjunction	τε/ὅτε
καὶ	conjunction	???/καί
πρόπαντι	adjective	πρόπας
βαρβάρων	noun	βάρβαρος
γένει	noun	γένος
.	SENT	.
εὖ	adverb	εὖ
νυν	adverb	νῦν#1/νῦν/νυν#2
τόδ̓	noun	<unknown>
ἴσθι	verb	εἰμί#1/εἰμί/οἶδα
,	SENT	,
μηδέπω	adverb	μηδέπω
μεσοῦν	verb	μεσόω
κακόν	adjective	κακός
·	SENT	:
τοιάδ̓	verb	<unknown>
ἐπ̓	verb	<unknown>
αὐτοῖς	pronoun	αὐτός
ἦλθε	verb	ἔρχομαι
συμφορὰ	noun	συμφορά
πάθους	noun	πάθος
ὡς	conjunction	ὥς/ὡς
τοῖσδε	pronoun	ὅδε
καὶ	conjunction	???/καί
δὶς	adverb	δίς
ἀντισηκῶσαι	verb	ἀντισηκόω
ῥοπῇ	noun	ῥοπή
.	SENT	.
καὶ	conjunction	???/καί
τίς	pronoun	τις/τίς/τὶς
γένοιτ̓	verb	<unknown>
ἂν	adverb	ἀν/ἄν/ἐάν
τῆσδ̓	verb	<unknown>
ἔτ̓	verb	<unknown>
ἐχθίων	adjective	ἐχθίων
τύχη	noun	τύχη
;	SENT	;
λέξον	verb	λέγω
τίν̓	verb	<unknown>
αὖ	adverb	αὖ/αὗ
φὴς	verb	φημί
τήνδε	pronoun	ὅδε
συμφορὰν	noun	συμφορά
στρατῷ	noun	στρατός
ἐλθεῖν	verb	ἔρχομαι
κακῶν	adjective	κακός
ῥέπουσαν	verb	ῥέπω
ἐς	preposition	εἰς
τὰ	article	ὁ/τίς
μάσσονα	noun	μάσσων
.	SENT	.
Περσῶν	noun	Πέρσης/Ρέρσης/πέρσης
ὅσοιπερ	adjective	ὅσος
ἦσαν	verb	εἰμί#1/εἰμί
ἀκμαῖοι	adjective	ἀκμαῖος
φύσιν	noun	φύσις
,	SENT	,
ψυχήν	noun	ψυχή
τ̓	verb	<unknown>
ἄριστοι	adjective	ἄριστος/ἀγαθός
κεὐγένειαν	noun	εὐγένεια
ἐκπρεπεῖς	adjective	ἐκπρεπής
,	SENT	,
αὐτῷ	pronoun	αὐτός
τ̓	adjective	<unknown>
ἄνακτι	noun	ἄναξ
πίστιν	noun	πίστις
ἐν	preposition	ἐν/εἰς
πρώτοις	adjective	πρότερος/πρῶτος
ἀεί	adverb	ἀεί
,	SENT	,
τεθνᾶσιν	verb	θνήσκω
αἰσχρῶς	adverb	αἰσχρός/αἰσχρῶς
δυσκλεεστάτῳ	adjective	δυσκλεής
μόρῳ	noun	μόρον/μόρος
.	SENT	.
οἲ	interjection	ὄι/οἰ/οἴ
̓	adjective	<unknown>
γὼ	pronoun	ἐγώ
τάλαινα	adjective	τάλας
συμφορᾶς	noun	συμφορεύς/συμφορά
κακῆς	adjective	κακός
,	SENT	,
φίλοι	adjective	φίλος
.	SENT	.
ποίῳ	pronoun	ποῖος
μόρῳ	noun	μόρον/μόρος
δὲ	adverb	δέ/οὐ
τούσδε	pronoun	ὅδε
φὴς	verb	φημί
ὀλωλέναι	verb	ὄλλυμι
;	SENT	;
νῆσός	noun	νῆσος
τις	pronoun	τις/τίς/τὶς
ἔστι	verb	εἰμί#1/εἰμί
πρόσθε	preposition	πρόσθεν
Σαλαμῖνος	noun	Σαλαμίς/σαλαμίς
τόπων	noun	τόπος
,	SENT	,
βαιά	adjective	βαιός
,	SENT	,
δύσορμος	adjective	δύσορμος
ναυσίν	noun	ναῦς
,	SENT	,
ἣν	pronoun	ὅς
ὁ	article	ὁ
φιλόχορος	adjective	φιλόχορος
Πὰν	noun	Πάν
ἐμβατεύει	verb	ἐμβατεύω
,	SENT	,
ποντίας	adjective	πόντιος
ἀκτῆς	noun	ἀκτή/ἀκτέα
ἔπι	verb	ἐπί/ἔπειμι
.	SENT	.
ἐνταῦθα	adverb	ἐνταῦθα
πέμπει	verb	πέμπω
τούσδ̓	verb	<unknown>
,	SENT	,
ὅπως	conjunction	ὅπως
,	SENT	,
ὅταν	adverb	ὅταν
νεῶν	noun	ναῦς/νεώς/ναός/νέα
φθαρέντες	verb	φθείρω
ἐχθροὶ	adjective	ἐχθρός
νῆσον	noun	νῆσος
ἐκσῳζοίατο	verb	ἐκσῴζω
,	SENT	,
κτείνοιεν	verb	κτείνω
εὐχείρωτον	adjective	εὐχείρωτος
Ἑλλήνων	noun	Ἕλλην/῞ἕλλην
στρατόν	noun	στρατός
,	SENT	,
φίλους	adjective	φίλος
δ̓	adjective	<unknown>
ὑπεκσῴζοιεν	verb	ὑπεκσῴζω
ἐναλίων	adjective	ἐνάλιος
πόρων	noun	πόρος
,	SENT	,
κακῶς	adverb	κακῶς/κακός
τὸ	article	ὁ
μέλλον	verb	μέλλω
ἱστορῶν	verb	ἱστορέω
.	SENT	.
ὡς	adverb	ὡς#2/ʽὡς/ὥς/ὡς
γὰρ	particle	γάρ
θεὸς	noun	θεός
ναῶν	noun	ναῦς/ναός
ἔδωκε	verb	δίδωμι
κῦδος	noun	κῦδος
Ἕλλησιν	noun	Ἕλλην/῞ἕλλην
μάχης	noun	μαχή/μάχη
,	SENT	,
αὐθημερὸν	adverb	αὐθήμερος
φράξαντες	verb	φράζω/φράσσω
εὐχάλκοις	adjective	εὔχαλκος
δέμας	noun	δέμας
ὅπλοισι	noun	ὅπλον
ναῶν	noun	ναῦς/ναός
ἐξέθρῳσκον	verb	ἐκθρῴσκω
·	SENT	:
ἀμφὶ	preposition	ἀμφί
δὲ	particle	μηδέ/δέ/οὐδέ
κυκλοῦντο	verb	κυκλόω/κυκλέω
πᾶσαν	pronoun	πᾶς
νῆσον	noun	νῆσος
,	SENT	,
ὥστ̓	adverb	<unknown>
ἀμηχανεῖν	verb	ἀμηχανάω/ἀμηχανέω
ὅποι	adverb	ὅποι
τράποιντο	verb	τρέπω
.	SENT	.
πολλὰ	adjective	πολύς
μὲν	particle	μέν
γὰρ	particle	γάρ
ἐκ	preposition	ἐκ
χερῶν	noun	χείρ
πέτροισιν	noun	πέτρος
ἠράσσοντο	verb	ἀράσσω
,	SENT	,
τοξικῆς	adjective	τοξικός
τ̓	verb	<unknown>
ἄπο	preposition	ἀπό
θώμιγγος	noun	θῶμιγξ
ἰοὶ	noun	ἰός
προσπίτνοντές	verb	προσπίπτω
ὤλλυσαν	verb	ὄλλυμι
·	SENT	:
τέλος	noun	τέλος
δ̓	adjective	<unknown>
ἐφορμηθέντες	verb	ἐφορμάω/ἐφορμέω
ἐξ	preposition	ἐκ
ἑνὸς	adjective	εἷς/εἵς
ῥόθου	noun	ῥόθος
παίουσι	verb	παίω
,	SENT	,
κρεοκοποῦσι	verb	κρεοκοπέω
δυστήνων	adjective	δύστηνος
μέλη	noun	μέλη/μέλος
,	SENT	,
ἕως	conjunction	ἑώς/ἕως/ἔως
ἁπάντων	adjective	ἅπας
ἐξαπέφθειραν	verb	ἐξαποφθείρω
βίον	noun	βίος
.	SENT	.
Ξέρξης	noun	Ξέρξης/Ξήρξης
δ̓	adjective	<unknown>
ἀνῴμωξεν	verb	ἀνοιμώζω
κακῶν	adjective	κακός
ὁρῶν	verb	ὁράω
βάθος	noun	βάθος
·	SENT	:
ἕδραν	noun	ἕδρα
γὰρ	particle	γάρ
εἶχε	verb	ἔχω
παντὸς	pronoun	πᾶς
εὐαγῆ	adjective	εὐαγής
στρατοῦ	noun	στρατός
,	SENT	,
ὑψηλὸν	adjective	ὑψηλός
ὄχθον	noun	ὄχθος
ἄγχι	preposition	ἄγχι
πελαγίας	adjective	πελάγιος
ἁλός	noun	ἅλς
·	SENT	:
ῥήξας	verb	ῥήγνυμι/ῥήσσω
δὲ	particle	μηδέ/δέ/οὐδέ
πέπλους	noun	πεπλος/πέπλος
κἀνακωκύσας	verb	ἀνακωκύω
λιγύ	adjective	λιγύς
,	SENT	,
πεζῷ	adjective	πεζός
παραγγείλας	verb	παραγγέλλω
ἄφαρ	adverb	ἄφαρ
στρατεύματι	noun	στράτευμα
,	SENT	,
ἵησ̓	verb	<unknown>
ἀκόσμῳ	adjective	ἄκοσμος
ξὺν	preposition	σύν
φυγῇ	noun	φυγή
.	SENT	.
τοιάνδε	pronoun	τοιόσδε
σοι	pronoun	σοι/σύ
πρὸς	preposition	πρός
τῇ	article	ὁ/τῇ
πάροιθε	adverb	πάροιθε
συμφορὰν	noun	συμφορά
πάρα	verb	πάρειμι/πάρα
στένειν	verb	στένω
.	SENT	.
ὦ	interjection	ὦ
στυγνὲ	adjective	στυγνός
δαῖμον	noun	δαίμων
,	SENT	,
ὡς	conjunction	ὥς/ὡς
ἄῤ	adjective	<unknown>
ἔψευσας	verb	ψεύδω
φρενῶν	noun	φρήν
Πέρσας	noun	Πέρσης
·	SENT	:
πικρὰν	adjective	πικρός
δὲ	particle	μηδέ/δέ/οὐδέ
παῖς	noun	παῖς
ἐμὸς	adjective	ἐμός
τιμωρίαν	noun	τιμωρία
κλεινῶν	adjective	κλεινός
Ἀθηνῶν	noun	̓ἀθῆναι/Ἀθῆναι
ηὗρε	verb	εὑρίσκω
,	SENT	,
κοὐκ	adverb	οὐ
ἀπήρκεσαν	verb	ἀπαρκέω/ἀπαίρω
οὓς	pronoun	ὁ/ὅς
πρόσθε	adverb	πρόσθεν
Μαραθὼν	proper	Μαραθών
βαρβάρων	noun	βάρβαρος
ἀπώλεσεν	verb	ἀπόλλυμι
·	SENT	:
ὧν	pronoun	ὅς
ἀντίποινα	noun	ἀντίποινα
παῖς	noun	παῖς
ἐμὸς	adjective	ἐμός
πράξειν	verb	πράσσω
δοκῶν	verb	δοκόω/δοκάζω/δοκέω
τοσόνδε	pronoun	τοσόσδε
πλῆθος	noun	πλῆθος
πημάτων	noun	πῆμα
ἐπέσπασεν	verb	ἐπισπάω
.	SENT	.
σὺ	pronoun	σύ
δ̓	adjective	<unknown>
εἰπέ	verb	λέγω/εἶπον
,	SENT	,
ναῶν	noun	ναῦς/ναός
αἳ	pronoun	ὁ/ὅς
πεφεύγασιν	verb	φεύγω
μόρον	noun	μόρον/μόρος
,	SENT	,
ποῦ	adverb	ποῦ/πού
τάσδ̓	adjective	<unknown>
ἔλειπες	verb	λείπω
·	SENT	:
οἶσθα	verb	εἴδω/οἶδα
σημῆναι	verb	σημαίνω
τορῶς	adverb	τορός
;	SENT	;
ναῶν	noun	ναῦς/ναός
γε	particle	γε
ταγοὶ	noun	ταγός
τῶν	article	ὁ/ὅς
λελειμμένων	verb	λείπω
σύδην	adverb	σύδην
κατ̓	verb	<unknown>
οὖρον	noun	ὅρος/ὅρος#2/οὖρος/οὖρον
οὐκ	adverb	οὐ
εὔκοσμον	adjective	εὔκοσμος
αἴρονται	verb	αἴρω
φυγήν	noun	φυγή
·	SENT	:
στρατὸς	noun	στρατός
δ̓	verb	<unknown>
ὁ	article	ὁ
λοιπὸς	adjective	λοιπός
ἔν	preposition	ἐν/εἰς/ἔν
τε	particle	τε/??/οὔτε
Βοιωτῶν	noun	βοιωτός/Βοιωτός
χθονὶ	noun	χθών
διώλλυθ̓	verb	<unknown>
,	SENT	,
οἱ	pronoun	/οὗ/ὅς/ἕ/ὁ
μὲν	particle	μέν
ἀμφὶ	preposition	ἀμφί
κρηναῖον	adjective	κρηναῖος
γάνος	noun	γάνος
δίψῃ	noun	δίψα
πονοῦντες	verb	πονέω
,	SENT	,
οἱ	article	ὁ/ὀ/οὗ
δ̓	adjective	<unknown>
ὑπ̓	verb	<unknown>
ἄσθματος	noun	ἆσθμα/ἄσθμα
κενοὶ	adjective	κενός
διεκπερῶμεν	verb	διεκπεράω
ἔς	preposition	εἰς
τε	particle	τε/??/οὔτε
Φωκέων	noun	Φωκεύς/Φωκαιεύς/φώκη/φωκεύς
χθόνα	noun	χθών
καὶ	conjunction	???/καί
Δωρίδ̓	verb	<unknown>
αἶαν	noun	αἶα
,	SENT	,
Μηλιᾶ	noun	μηλιεύς
τε	particle	τε/??/οὔτε
κόλπον	noun	κόλπος
,	SENT	,
οὗ	pronoun	ὁς/ὅς/ἕ
Σπερχειὸς	noun	Σπερχειός
ἄρδει	verb	ἄρδω
πεδίον	noun	πεδίον
εὐμενεῖ	adjective	εὐμενής
ποτῷ	adjective	ποτός
·	SENT	:
κἀντεῦθεν	adverb	ἐντεῦθεν
ἡμᾶς	pronoun	ἐγώ/ἡμεῖς
γῆς	noun	Γαῖα/γῆ
Ἀχαιίδος	noun	Ἀχαιίς
πέδον	noun	πέδον
καὶ	conjunction	???/καί
Θεσσαλῶν	noun	Θεσσαλός
πόλεις	noun	πολίς/πόλις/πόόλις
ὑπεσπανισμένους	verb	ὑποσπανίζομαι
βορᾶς	noun	βορά
ἐδέξαντ̓	verb	<unknown>
·	SENT	:
ἔνθα	adverb	ἔνθα
δὴ	particle	δή
πλεῖστοι	adjective	πλεῖστος/πολύς
̓	verb	<unknown>
θάνον	verb	θνήσκω
δίψῃ	noun	δίψα
τε	particle	τε/??/οὔτε
λιμῷ	noun	λιμός
τ̓	verb	<unknown>
·	SENT	:
ἀμφότερα	adjective	ἀμφότερος/ἀμφότεροι
γὰρ	particle	γάρ
ἦν	verb	είμί/εἰμί#1/εἰμί/ἠμί
τάδε	pronoun	ὅδε
.	SENT	.
Μαγνητικὴν	adjective	Μαγνητικός
δὲ	particle	μηδέ/δέ/οὐδέ
γαῖαν	noun	γαῖα
ἔς	preposition	εἰς
τε	particle	τε/??/οὔτε
Μακεδόνων	noun	Μακεδών
χώραν	noun	χώρα
ἀφικόμεσθ̓	verb	<unknown>
,	SENT	,
ἐπ̓	verb	<unknown>
Ἀξίου	adjective	ἄξιος
πόρον	noun	πόρος
,	SENT	,
Βόλβης	noun	Βόλβη
θ̓	verb	<unknown>
ἕλειον	adjective	ἕλειος
δόνακα	noun	δόναξ
,	SENT	,
Πάγγαιόν	noun	Πάγγαιον
τ̓	adjective	<unknown>
ὄρος	noun	ὄρος/ὄρος#1
,	SENT	,
Ἠδωνίδ̓	verb	<unknown>
αἶαν	noun	αἶα
·	SENT	:
νυκτὶ	noun	νύξ
δ̓	verb	<unknown>
ἐν	preposition	ἐν/εἰς
ταύτῃ	pronoun	οὗτος/αὐτός
θεὸς	noun	θεός
χειμῶν̓	verb	<unknown>
ἄωρον	adjective	ἄωρος
ὦρσε	verb	ὄρνυμι
,	SENT	,
πήγνυσιν	noun	πήγνυσις
δὲ	particle	μηδέ/δέ/οὐδέ
πᾶν	adjective	πᾶς
ῥέεθρον	noun	ῥεῖθρον
ἁγνοῦ	adjective	ἁγνός
Στρυμόνος	noun	Στρυμών
.	SENT	.
θεοὺς	noun	θεός
δέ	particle	δέ/οὐδέ
τις	pronoun	τις/τίς/τὶς
τὸ	article	ὁ
πρὶν	adverb	πρίν
νομίζων	verb	νομίζω
οὐδαμοῦ	adverb	οὐδαμός/οὐδαμοῦ
τότ̓	verb	<unknown>
ηὔχετο	verb	εὔχομαι
λιταῖσι	noun	λιτή
,	SENT	,
γαῖαν	noun	γαῖα
οὐρανόν	noun	οὐρανός
τε	conjunction	τε/ὅτε
προσκυνῶν	verb	προσκυνέω
.	SENT	.
ἐπεὶ	conjunction	ἐπεί
δὲ	adverb	δέ/οὐ
πολλὰ	adjective	πολύς
θεοκλυτῶν	verb	θεοκλυτέω
ἐπαύσατο	verb	παύω/ἐπαύω
στρατός	noun	στρατός
,	SENT	,
περᾷ	verb	περάω
κρυσταλλοπῆγα	noun	κρυσταλλοπήξ
διὰ	preposition	διά
πόρον	noun	πόρος
·	SENT	:
χὤστις	pronoun	ὅστις
μὲν	particle	μέν
ἡμῶν	pronoun	σύ/ἐγώ/ἡμεῖς
πρὶν	adverb	πρίν
σκεδασθῆναι	verb	σκεδάννυμι
θεοῦ	noun	θέος/θεός
ἀκτῖνας	noun	ἀκτίς
ὡρμήθη	verb	ὁρμάω/ὁρμέω
,	SENT	,
σεσωσμένος	verb	σώζω
κυρεῖ	verb	κυρέω
.	SENT	.
φλέγων	verb	φλέγω
γὰρ	particle	γάρ
αὐγαῖς	noun	αὐγή
λαμπρὸς	adjective	λαμπρός
ἡλίου	noun	ἥλιος/ἤλιος
κύκλος	noun	κύκλος
μέσον	adjective	μέσος
πόρον	noun	πόρος
διῆκε	verb	διήκω/διίημι
,	SENT	,
θερμαίνων	verb	θερμαίνω
φλογί	noun	φλόξ/φλογίς
.	SENT	.
πῖπτον	verb	πίπτω
δ̓	adjective	<unknown>
ἐπ̓	verb	<unknown>
ἀλλήλοισιν	adjective	ἀλλήλων
·	SENT	:
ηὐτύχει	verb	εὐτυχέω
δέ	particle	δέ/οὐδέ
τοι	pronoun	σύ
ὅστις	pronoun	ὅστις
τάχιστα	adjective	ταχύς/τάχιστος
πνεῦμ̓	verb	<unknown>
ἀπέρρηξεν	verb	ἀπορρήγνυμι
βίου	noun	βίος/βιός
.	SENT	.
ὅσοι	pronoun	ὅσος
δὲ	particle	μηδέ/δέ/οὐδέ
λοιποὶ	adjective	λοιπός
κἄτυχον	verb	τυγχάνω
σωτηρίας	noun	σωτηρία
,	SENT	,
Θρῄκην	noun	θρᾴκη
περάσαντες	verb	περάω
μόγις	adverb	μόγις
πολλῷ	adjective	πολύς
πόνῳ	noun	πόνος
,	SENT	,
ἥκουσιν	verb	ἥκω
ἐκφυγόντες	verb	ἐκφεύγω
,	SENT	,
οὐ	adverb	οὐκ/οὔπως/οὐ
πολλοί	adjective	πολύς
τινες	pronoun	τις/τίς/τὶς
,	SENT	,
ἐφ̓	verb	<unknown>
ἑστιοῦχον	adjective	ἑστιοῦχος
γαῖαν	noun	γαῖα
·	SENT	:
ὡς	conjunction	ὥς/ὡς
στένειν	verb	στένω
πόλιν	noun	πόλις
Περσῶν	noun	Πέρσης/Ρέρσης/πέρσης
,	SENT	,
ποθοῦσαν	verb	ποθέω
φιλτάτην	adjective	φίλτατος
ἥβην	noun	ἥβη
χθονός	noun	χθών
.	SENT	.
ταῦτ̓	verb	<unknown>
ἔστ̓	verb	<unknown>
ἀληθῆ	adjective	ἀληθής
·	SENT	:
πολλὰ	adjective	πολύς
δ̓	adjective	<unknown>
ἐκλείπω	verb	ἐκλείπω
λέγων	verb	λέγω
κακῶν	adjective	κακός
ἃ	pronoun	ὁς/ὅς/ὁ
Πέρσαις	noun	Πέρσης/πέρσης
ἐγκατέσκηψεν	verb	ἐγκατασκήπτω
θεός	noun	θεός
.	SENT	.
ὦ	interjection	ὦ
δυσπόνητε	adjective	δυσπόνητος
δαῖμον	noun	δαίμων
,	SENT	,
ὡς	conjunction	ὥς/ὡς
ἄγαν	adverb	ἄγαν
βαρὺς	adjective	βαρύς
ποδοῖν	noun	πούς
ἐνήλου	adjective	ἔνηλος
παντὶ	pronoun	πᾶς
Περσικῷ	adjective	Περσικός/περσικός
γένει	noun	γένος
.	SENT	.
οἲ	interjection	ὄι/οἰ/οἴ
̓	adjective	<unknown>
γὼ	pronoun	ἐγώ
τάλαινα	adjective	τάλας
διαπεπραγμένου	verb	διαπράσσω
στρατοῦ	noun	στρατός
·	SENT	:
ὦ	interjection	ὦ
νυκτὸς	noun	νύξ
ὄψις	noun	ὄψις
ἐμφανὴς	adjective	ἐμφανής
ἐνυπνίων	adjective	ἐνύπνιος
,	SENT	,
ὡς	conjunction	ὥς/ὡς
κάρτα	adverb	κάρτα
μοι	pronoun	τις/ἐγώ
σαφῶς	adverb	σαφής/σαφῶς
ἐδήλωσας	verb	δηλόω
κακά	adjective	κακός
.	SENT	.
ὑμεῖς	pronoun	σύ/ὑμεῖς
δὲ	particle	μηδέ/δέ/οὐδέ
φαύλως	adverb	φαῦλος
αὔτ̓	verb	<unknown>
ἄγαν	adverb	ἄγαν
ἐκρίνατε	verb	κρίνω
.	SENT	.
ὅμως	adverb	ὅμως
δ̓	verb	<unknown>
,	SENT	,
ἐπειδὴ	conjunction	ἐπειδή/ἐπεί
τῇδ̓	adjective	<unknown>
ἐκύρωσεν	verb	κυρόω
φάτις	noun	φάτις
ὑμῶν	pronoun	σύ/ὑμεῖς
,	SENT	,
θεοῖς	noun	θεός
μὲν	particle	μέν
πρῶτον	adjective	πρότερος/πρῶτος
εὔξασθαι	verb	εὔχομαι
θέλω	verb	ἐθέλω
·	SENT	:
ἔπειτα	adverb	ἔπειτα
Γῇ	noun	γῆ
τε	conjunction	τε/ὅτε
καὶ	conjunction	???/καί
φθιτοῖς	adjective	φθιτός
δωρήματα	noun	δώρημα
ἥξω	verb	ἥκω
λαβοῦσα	verb	λαμβάνω
πέλανον	noun	πέλανος
ἐξ	preposition	ἐκ
οἴκων	noun	οἶκος
ἐμῶν	adjective	ἐμός
,	SENT	,
-	SENT	-
ἐπίσταμαι	verb	ἐπίσταμαι/ἐφίστημι
μὲν	particle	μέν
ὡς	adverb	ὡς#2/ʽὡς/ὥς/ὡς
ἐπ̓	verb	<unknown>
ἐξειργασμένοις	verb	ἐξεργάζομαι
,	SENT	,
ἀλλ̓	verb	<unknown>
ἐς	preposition	εἰς
τὸ	article	ὁ
λοιπὸν	adjective	λοιπός
εἴ	conjunction	εἰ
τι	pronoun	τις/τίς/τὶς
δὴ	adverb	δή
λῷον	adjective	λωίων
πέλοι	verb	πέλω
.	SENT	.
ὑμᾶς	pronoun	σύ/ὑμεῖς
δὲ	particle	μηδέ/δέ/οὐδέ
χρὴ	verb	χρή/χρὴ
̓	verb	<unknown>
πὶ	preposition	ἐπί
τοῖσδε	pronoun	ὅδε
τοῖς	article	ὁ
πεπραγμένοις	verb	πράσσω
πιστοῖσι	noun	πιστόν
πιστὰ	adjective	πιστός
ξυμφέρειν	verb	συμφέρω
βουλεύματα	noun	βούλευμα
·	SENT	:
καὶ	conjunction	???/καί
παῖδ̓	verb	<unknown>
,	SENT	,
ἐάν	conjunction	ἐάν
περ	particle	πέρ
δεῦῤ	verb	<unknown>
ἐμοῦ	pronoun	ἐμός/ἐγώ/ἐμώ
πρόσθεν	adverb	πρόσθεν
μόλῃ	verb	βλώσκω
,	SENT	,
παρηγορεῖτε	verb	παρηγορέω
,	SENT	,
καὶ	conjunction	???/καί
προπέμπετ̓	verb	<unknown>
ἐς	preposition	εἰς
δόμους	noun	δόμος
,	SENT	,
μὴ	adverb	μή/μὴ
καί	conjunction	καί
τι	pronoun	τις/τίς/τὶς
πρὸς	preposition	πρός
κακοῖσι	adjective	κακός
προσθῆται	verb	προστίθημι/προσθέω
κακόν	adjective	κακός
.	SENT	.
ὦ	interjection	ὦ
Ζεῦ	noun	Ζεύς/ζεύς
βασιλεῦ	noun	βασιλεύς
,	SENT	,
νῦν	adverb	νῦν#1/νῦν
γὰρ	particle	γάρ
Περσῶν	noun	Πέρσης/Ρέρσης/πέρσης
τῶν	article	ὁ/ὅς
μεγαλαύχων	adjective	μεγάλαυχος
καὶ	conjunction	???/καί
πολυάνδρων	adjective	πολύανδρος
στρατιὰν	noun	στρατιά
ὀλέσας	verb	ὄλλυμι
ἄστυ	noun	ἄστυ
τὸ	article	ὁ
Σούσων	proper	Σοῦσος/Σοῦσα
ἠδ̓	verb	<unknown>
Ἀγβατάνων	noun	/Ἐκβάτανα
πένθει	noun	πένθος
δνοφερῷ	adjective	δνοφερός
κατέκρυψας	verb	κατακρύπτω
·	SENT	:
πολλαὶ	adjective	πολύς
δ̓	verb	<unknown>
ἀταλαῖς	adjective	ἀταλός
χερσὶ	noun	χείρ
καλύπτρας	noun	καλύπτρα/κάλυπτρα
κατερεικόμεναι	verb	κατερείκω
διαμυδαλέοις	adjective	διαμυδαλέος
δάκρυσι	noun	δάκρυον
κόλπους	noun	κόλπος
τέγγουσ̓	verb	<unknown>
,	SENT	,
ἄλγους	noun	ἄλγος
μετέχουσαι	verb	μετέχω
.	SENT	.
αἱ	article	ὁ
δ̓	adjective	<unknown>
ἁβρόγοοι	adjective	ἁβρόγοος
Περσίδες	noun	περσίς/Περσίς
ἀνδρῶν	noun	ἀνήρ
ποθέουσαι	verb	ποθέω
ἰδεῖν	verb	ἰδέω/εἶδον/ὁράω
ἀρτιζυγίαν	noun	ἀρτιζυγία
,	SENT	,
λέκτρων	noun	λέκτρον
εὐνὰς	noun	εὐνή
ἁβροχίτωνας	noun	ἁβροχίτων
,	SENT	,
χλιδανῆς	adjective	χλιδανός
ἥβης	noun	ἥβη
τέρψιν	noun	τέρψις
,	SENT	,
ἀφεῖσαι	verb	ἀφίημι
,	SENT	,
πενθοῦσι	verb	πενθέω
γόοις	noun	γόος
ἀκορεστοτάτοις	adjective	ἀκόρεστος
.	SENT	.
κἀγὼ	pronoun	ἐγώ
δὲ	particle	μηδέ/δέ/οὐδέ
μόρον	noun	μόρον/μόρος
τῶν	article	ὁ/ὅς
οἰχομένων	verb	οἴχομαι
αἴρω	verb	αἴρω
δοκίμως	adverb	δόκιμος
πολυπενθῆ	adjective	πολυπενθής
.	SENT	.
νῦν	adverb	νῦν#1/νῦν
γὰρ	particle	γάρ
δὴ	particle	δή
πρόπασα	adjective	πρόπας
μὲν	adverb	μέν
στένει	verb	στένω
γαῖ̓	adjective	<unknown>
Ἀσιὰς	noun	Ἀσιάς
ἐκκενουμένα	verb	ἐκκενόω
.	SENT	.
Ξέρξης	noun	Ξέρξης/Ξήρξης
μὲν	particle	μέν
ἄγαγεν	verb	ἄγω
,	SENT	,
ποποῖ	interjection	πόποι
,	SENT	,
Ξέρξης	noun	Ξέρξης/Ξήρξης
δ̓	adjective	<unknown>
ἀπώλεσεν	verb	ἀπόλλυμι
,	SENT	,
τοτοῖ	interjection	τοτοῖ/ὀτοτοῖ
,	SENT	,
Ξέρξης	noun	Ξέρξης/Ξήρξης
δὲ	particle	μηδέ/δέ/οὐδέ
πάντ̓	adjective	<unknown>
ἐπέσπε	verb	ἐφέπω
δυσφρόνως	adverb	δύσφρων/δυσφρόνως
βαρίδεσσι	noun	βᾶρις
ποντίαις	adjective	πόντιος
.	SENT	.
τίπτε	adverb	τίπτε
Δαρεῖος	noun	Δαρεῖος/δαρεῖος
μὲν	adverb	μέν
οὕ	unknown	unknown
-	SENT	-
τω	adverb	οὕτω
τότ̓	verb	<unknown>
ἀβλαβὴς	adjective	ἀβλαβής
ἐπῆν	verb	ἔπειμι#1/ἔπειμι
τόξαρχος	noun	τόξαρχος
πολιήταις	noun	πολίτης
,	SENT	,
Σουσίδαις	noun	Σουσίς
φίλος	adjective	φίλος
ἄκτωρ	noun	ἄκτωρ
;	SENT	;
πεζούς	adjective	πεζός
τε	particle	τε/??/οὔτε
γὰρ	adverb	γάρ
καὶ	conjunction	???/καί
θαλασσίους	adjective	θαλάσσιος
λινόπτεροι	adjective	λινόπτερος
κυανώπιδες	noun	κυανῶπις
νᾶες	noun	ναῦς
μὲν	adverb	μέν
ἄγαγον	verb	ἄγω
,	SENT	,
ποποῖ	interjection	πόποι
,	SENT	,
νᾶες	noun	ναῦς
δ̓	adjective	<unknown>
ἀπώλεσαν	verb	ἀπόλλυμι
,	SENT	,
τοτοῖ	interjection	τοτοῖ/ὀτοτοῖ
,	SENT	,
νᾶες	noun	ναῦς
πανωλέθροισιν	adjective	πανώλεθρος
ἐμβολαῖς	noun	ἐμβολή
,	SENT	,
αἵ	pronoun	ὁ/ὅς
τ̓	adjective	<unknown>
Ἰαόνων	noun	̓ἰάων/Ἰάονες
χέρες	noun	χείρ
.	SENT	.
τυτθὰ	adjective	τυτθός
δ̓	adjective	<unknown>
ἐκφυγεῖν	verb	ἐκφεύγω
ἄνακτ̓	verb	<unknown>
αὐτὸν	pronoun	αὐτός
εἰσακούομεν	verb	εἰσακούω
Θρῄκης	noun	Θρᾴκη/θρᾴκη
ἂμ	preposition	ἀνά
πεδιήρεις	adjective	πεδιήρης
δυσχίμους	adjective	δύσχιμος
τε	particle	τε/??/οὔτε
κελεύθους	noun	κέλευθος
.	SENT	.
τοὶ	pronoun	ὁ//σύ/ὅς
δ̓	adjective	<unknown>
ἄρα	particle	ἄρα
πρωτόμοιροι	adjective	πρωτόμοιρος
,	SENT	,
φεῦ	interjection	φεῦ
,	SENT	,
λειφθέντες	verb	λείπω
πρὸς	preposition	πρός
ἀνάγκας	noun	ἀνάγκη
,	SENT	,
ἠέ	conjunction	ἤ/ἠέ
,	SENT	,
ἀκτὰς	noun	ἀκτή
ἀμφὶ	preposition	ἀμφί
Κυχρείας	noun	Κύχρεια
,	SENT	,
ὀᾶ	interjection	ὀᾶ
,	SENT	,
σύρονται	verb	σύρω
·	SENT	:
στένε	verb	στένω
καὶ	conjunction	???/καί
δακνά	unknown	unknown
-	SENT	-
ζου	verb	δακνάζομαι
,	SENT	,
βαρὺ	adjective	βαρύς
δ̓	adjective	<unknown>
ἀμβόασον	verb	ἀναβοάω
οὐράνἰ	adjective	<unknown>
ἄχη	noun	ἄχος
,	SENT	,
ὀᾶ	interjection	ὀᾶ
·	SENT	:
τεῖνε	verb	τείνω
δὲ	particle	μηδέ/δέ/οὐδέ
δυσβάυκτον	adjective	δυσβάυκτος
βοᾶτιν	noun	βοητής
τάλαιναν	adjective	τάλας
αὐδάν	noun	αὐδή
.	SENT	.
γναπτόμενοι	verb	κνάπτω
δὲ	particle	μηδέ/δέ/οὐδέ
δίνᾳ	noun	δίνη
,	SENT	,
φεῦ	interjection	φεῦ
,	SENT	,
σκύλλονται	verb	σκύλλω
πρὸς	preposition	πρός
ἀναύδων	adjective	ἄναυδος
,	SENT	,
ἠέ	conjunction	ἤ/ἠέ
,	SENT	,
παίδων	noun	παῖς
τᾶς	article	ὁ
ἀμιάντου	adjective	ἀμίαντος
,	SENT	,
ὀᾶ	interjection	ὀᾶ
.	SENT	.
πενθεῖ	verb	πενθέω
δ̓	adjective	<unknown>
ἄνδρα	noun	ἀνήρ
δόμος	noun	δόμος
στερη	unknown	unknown
-	SENT	-
θείς	verb	στερέω/τίθημι
τοκέες	noun	τοκεύς
τ̓	adjective	<unknown>
ἄπαιδες	noun	ἄπαις
δαιμόνἰ	verb	<unknown>
ἄχη	noun	ἄχος
,	SENT	,
ὀᾶ	interjection	ὀᾶ
,	SENT	,
δυρόμενοι	verb	ὀδύρομαι
γέροντες	noun	γέρων
τὸ	article	ὁ
πᾶν	adjective	πᾶς
δὴ	adverb	δή
κλύουσιν	verb	κλύω
ἄλγος	noun	ἄλγος
.	SENT	.
τοὶ	pronoun	ὁ//σύ/ὅς
δ̓	verb	<unknown>
ἀνὰ	preposition	ἀνά
γᾶν	noun	γῆ
Ἀσίαν	noun	Ἀσία/̓Ασία
δὴν	adverb	δήν
οὐκέτι	adverb	οὐκέτι
περσονομοῦνται	verb	περσονομέομαι/Περσονομέομαι
,	SENT	,
οὐ	adverb	οὐκ/οὔπως/οὐ
δ̓	verb	<unknown>
ἔτι	adverb	ἔτι
δασμοφοροῦσιν	verb	δασμοφορέω
δεσποσύνοισιν	adjective	δεσπόσυνος
ἀνάγκαις	noun	ἀνάγκη
,	SENT	,
οὐ	adverb	οὐκ/οὔπως/οὐ
δ̓	verb	<unknown>
ἐς	preposition	εἰς
γᾶν	noun	γῆ
προπίτνοντες	verb	προπίπτω/προπίτνω
ἅζονται	verb	ἅζομαι
·	SENT	:
βασιλεία	noun	βασιλεία
γὰρ	particle	γάρ
διόλωλεν	verb	διόλλυμι
ἰσχύς	noun	ἰσχύς
.	SENT	.
οὐ	adverb	οὐκ/οὔπως/οὐ
δ̓	verb	<unknown>
ἔτι	adverb	ἔτι
γλῶσσα	noun	γλῶσσα
βροτοῖσιν	noun	βροτός
ἐν	preposition	ἐν/εἰς
φυλακαῖς	noun	φυλακή
·	SENT	:
λέλυται	verb	λύω
γὰρ	particle	γάρ
λαὸς	noun	λαός
ἐλεύθερα	adjective	ἐλεύθερος
βάζειν	verb	βάζω
,	SENT	,
ὡς	conjunction	ὥς/ὡς
ἐλύθη	verb	λύω
ζυγὸν	noun	ζυγός/ζυγόν
ἀλκᾶς	verb	ἀλκάζω
.	SENT	.
αἱμαχθεῖσα	verb	αἱμάσσω
δ̓	adjective	<unknown>
ἄρουραν	noun	ἄρουρα
Αἴαντος	noun	Αἴας/αἴας
περικλύστα	adjective	περίκλυστος
νᾶσος	noun	νῆσος
ἔχει	verb	ἐχώ/ἔχω/χέω/χάω
τὰ	article	ὁ/τίς
Περσᾶν	noun	Πέρσης/πέρσης
.	SENT	.
φίλοι	adjective	φίλος
,	SENT	,
κακῶν	adjective	κακός
μὲν	particle	μέν
ὅστις	pronoun	ὅστις
ἔμπειρος	adjective	ἔμπειρος
κυρεῖ	verb	κυρέω
,	SENT	,
ἐπίσταται	verb	ἐπίσταμαι/ἐφίστημι
βροτοῖσιν	noun	βροτός
ὡς	conjunction	ὥς/ὡς
ὅταν	adverb	ὅταν
κλύδων	noun	κλύδων
κακῶν	adjective	κακός
ἐπέλθῃ	verb	ἐπέρχομαι
πάντα	pronoun	πᾶς
δειμαίνειν	verb	δειμαίνω
φιλεῖ	verb	φιλέω
·	SENT	:
ὅταν	conjunction	ὅταν
δ̓	verb	<unknown>
ὁ	article	ὁ
δαίμων	noun	δαίμων
εὐροῇ	verb	εὐροέω
,	SENT	,
πεποιθέναι	verb	πείθω
τὸν	pronoun	ὁ//ὅς/ὁς
αὐτὸν	pronoun	αὐτός
αἰεὶ	adverb	ἀεί
δαίμον̓	verb	<unknown>
οὐριεῖν	verb	ὁρίζω/οὐρίζω
τύχην	noun	τύχη
.	SENT	.
ἐμοὶ	pronoun	ἐμός/ἐγώ
γὰρ	particle	γάρ
ἤδη	adverb	ἠδή/ἤδη/ἦδη
πάντα	pronoun	πᾶς
μὲν	adverb	μέν
φόβου	noun	φόβος
πλέα	adjective	πλέος/πλέως
ἐν	preposition	ἐν/εἰς
ὄμμασιν	noun	ὄμμα
τἀνταῖα	adjective	ἀνταῖος
φαίνεται	verb	φαίνω
θεῶν	noun	θέος/θεεός/θέα/θεά/θεός/θεὸς
,	SENT	,
βοᾷ	verb	βοάω
δ̓	verb	<unknown>
ἐν	preposition	ἐν/εἰς
ὠσὶ	noun	οὖς
κέλαδος	noun	κέλαδος
οὐ	adverb	οὐκ/οὔπως/οὐ
παιώνιος	noun	παιώνιος
·	SENT	:
τοία	adjective	τοῖος
κακῶν	adjective	κακός
ἔκπληξις	noun	ἔκπληξις
ἐκφοβεῖ	verb	ἐκφοβέω
φρένας	noun	φρήν
.	SENT	.
τοιγὰρ	particle	τοιγάρ
κέλευθον	noun	κέλευθος
τήνδ̓	verb	<unknown>
ἄνευ	preposition	ἄνευ
τ̓	adjective	<unknown>
ὀχημάτων	noun	ὄχημα
χλιδῆς	noun	χλιδή
τε	conjunction	τε/ὅτε
τῆς	article	ὁ
πάροιθεν	adverb	πάροιθεϝ/πάροιθε
ἐκ	preposition	ἐκ
δόμων	noun	δόμος
πάλιν	adverb	πάλιν
ἔστειλα	verb	στέλλω
,	SENT	,
παιδὸς	noun	παῖς
πατρὶ	noun	πατρίς/πατήρ
πρευμενεῖς	adjective	/πρευμενής
χοὰς	noun	χοή
φέρουσ̓	verb	<unknown>
,	SENT	,
ἅπερ	pronoun	ὅς/ὅσπερ/ὁσπερ
νεκροῖσι	noun	νεκρός
μειλικτήρια	adjective	μειλικτήριος
,	SENT	,
βοός	noun	βοῦς
τ̓	adjective	<unknown>
ἀφ̓	verb	<unknown>
ἁγνῆς	adjective	ἁγνός
λευκὸν	adjective	λευκός
εὔποτον	adjective	εὔποτος
γάλα	noun	γάλα
,	SENT	,
τῆς	article	ὁ
τ̓	adjective	<unknown>
ἀνθεμουργοῦ	adjective	ἀνθεμουργός
στάγμα	noun	στάγμα
,	SENT	,
παμφαὲς	adjective	παμφαής
μέλι	noun	μέλι
,	SENT	,
λιβάσιν	noun	λιβάς
ὑδρηλαῖς	adjective	ὑδρηλός
παρθένου	noun	παρθένος
πηγῆς	noun	πηγή
μέτα	verb	μέτειμι/μέτα
,	SENT	,
ἀκήρατόν	adjective	ἀκήρατος
τε	particle	τε/??/οὔτε
μητρὸς	noun	μήτηρ
ἀγρίας	adjective	ἄγριος
ἄπο	preposition	ἀπό
ποτὸν	adjective	ποτός
παλαιᾶς	adjective	παλαιός
ἀμπέλου	noun	ἄμπελος
γάνος	noun	γάνος
τόδε	pronoun	ὅδε
·	SENT	:
τῆς	article	ὁ
τ̓	adjective	<unknown>
αἰὲν	adverb	ἀεί
ἐν	preposition	ἐν/εἰς
φύλλοισι	noun	φύλλον
θαλλούσης	verb	θάλλω
βίον	noun	βίος
ξανθῆς	adjective	ξανθός
ἐλαίας	noun	ἐλαία
καρπὸς	noun	καρπός
εὐώδης	adjective	εὐώδης
πάρα	verb	πάρειμι/πάρα
,	SENT	,
ἄνθη	noun	ἄνθη/ἄνθος
τε	particle	τε/??/οὔτε
πλεκτά	noun	πλεκτή
,	SENT	,
παμφόρου	adjective	πάμφορος
γαίας	noun	γαῖα
τέκνα	noun	τέκνον
,	SENT	,
ἀλλ̓	verb	<unknown>
,	SENT	,
ὦ	interjection	ὦ
φίλοι	adjective	φίλος
,	SENT	,
χοαῖσι	noun	χοή
ταῖσδε	pronoun	ὅδε
νερτέρων	adjective	νέρτερος
ὕμνους	noun	ὕμνος
ἐπευφημεῖτε	verb	ἐπευφημέω
,	SENT	,
τόν	pronoun	ὁ/ὅς
τε	particle	τε/??/οὔτε
δαίμονα	noun	δαίμων
Δαρεῖον	proper	Δαρεῖος
ἀνακαλεῖσθε	verb	ἀνακαλέω
,	SENT	,
γαπότους	adjective	γάποτος
δ̓	verb	<unknown>
ἐγὼ	pronoun	ἐγώ
τιμὰς	noun	τιμή
προπέμψω	verb	προπέμπω
τάσδε	pronoun	ὅδε
νερτέροις	adjective	νέρτερος
θεοῖς	noun	θεός
.	SENT	.
βασίλεια	noun	βασίλεια#1/βασίλεια/βασίλειον
γύναι	noun	γυνή
,	SENT	,
πρέσβος	noun	πρέσβος
Πέρσαις	noun	Πέρσης/πέρσης
,	SENT	,
σύ	pronoun	σύ
τε	particle	τε/??/οὔτε
πέμπε	verb	πέμπω
χοὰς	noun	χοή
θαλάμους	noun	θάλαμος
ὑπὸ	preposition	ὑπό
γῆς	noun	Γαῖα/γῆ
,	SENT	,
ἡμεῖς	pronoun	ἐγώ/ἡμεῖς
θ̓	adjective	<unknown>
ὕμνοις	noun	ὕμνος
αἰτησόμεθα	verb	αἰτέω
φθιμένων	verb	φθίω
πομποὺς	noun	πομπός
εὔφρονας	adjective	εὔφρων
εἶναι	verb	εἰμί#1/εἰμί
κατὰ	preposition	κατά
γαίας	noun	γαῖα
.	SENT	.
ἀλλά	adverb	ἀλλά
,	SENT	,
χθόνιοι	adjective	χθόνιος
δαίμονες	noun	δαίμων
ἁγνοί	adjective	ἁγνός
,	SENT	,
Γῆ	noun	Γαῖα/γῆ
τε	particle	τε/??/οὔτε
καὶ	conjunction	???/καί
Ἑρμῆ	noun	ʽἑρμῆς/Ἑρμῆς
,	SENT	,
βασιλεῦ	noun	βασιλεύς
τ̓	adjective	<unknown>
ἐνέρων	noun	ἔνεροι
,	SENT	,
πέμψατ̓	verb	<unknown>
ἔνερθεν	adverb	ἔνερθε
ψυχὴν	noun	ψυχή
ἐς	preposition	εἰς
φῶς	noun	φάος/φῶς
·	SENT	:
εἰ	conjunction	εἰ
γάρ	particle	γάρ
τι	pronoun	τις/τίς/τὶς
κακῶν	adjective	κακός
ἄκος	noun	ἄκος
οἶδε	verb	εἴδω/οἶδα
πλέον	adjective	πλέος/πλείων/πλέως/πολύς
,	SENT	,
μόνος	adjective	μόνος
ἂν	particle	ἄν
θνητῶν	adjective	θνητός
πέρας	noun	πέρα/πέρας
εἴποι	verb	λέγω/εἶπον
.	SENT	.
ἦ	adverb	ἦ/ἦ#2
ῥ̓	adjective	<unknown>
ἀίει	verb	ἀίω
μου	pronoun	ἐγώ
μακαρίτας	noun	μακαρίτης
ἰσοδαίμων	adjective	ἰσοδαίμων
βασιλεὺς	noun	βασιλεύς
βάρβαῤ	verb	<unknown>
ἀσαφηνῆ	adjective	ἀσαφηνής
ἱέντος	verb	ἵημι
τὰ	article	ὁ/τίς
παναίολ̓	noun	<unknown>
αἰ	conjunction	εἰ
-	SENT	-
ανῆ	adjective	αἰανής
δύσθροα	adjective	δύσθρους/δύσθροος
βάγματ̓	verb	<unknown>
,	SENT	,
ἢ	conjunction	ἤ
παντάλαν̓	adjective	<unknown>
ἄχη	noun	ἄχος
διαβοάσω	verb	διαβοάω
;	SENT	;
νέρθεν	adverb	ἔνερθεν/ἔνερθε
ἆρα	particle	ἆρα
κλύει	verb	κλύω
μου	pronoun	ἐγώ
;	SENT	;
ἀλλὰ	conjunction	ἀλλά/ἀλλὰ
σύ	pronoun	σύ
μοι	pronoun	τις/ἐγώ
Γᾶ	noun	γῆ
τε	conjunction	τε/ὅτε
καὶ	conjunction	???/καί
ἄλλοι	adjective	ἄλλος
χθονίων	adjective	χθόνιος
ἁγεμόνες	noun	ἡγεμών
δαίμονα	noun	δαίμων
μεγαυχῆ	adjective	μεγαυχής
ἰόντ̓	verb	<unknown>
αἰνέσατ̓	verb	<unknown>
ἐκ	preposition	ἐκ
δόμων	noun	δόμος
,	SENT	,
Περσᾶν	noun	Πέρσης/πέρσης
Σουσιγενῆ	adjective	Σουσιγενής
θεόν	noun	θεός
·	SENT	:
πέμπετε	verb	πέμπω
δ̓	verb	<unknown>
ἄνω	adverb	ἄνω
οἷον	adjective	οἷος
οὔπω	adverb	οὔπω
Περσὶς	noun	Περσίς
αἶ̓	adjective	<unknown>
ἐκάλυψεν	verb	καλύπτω
.	SENT	.
ἦ	adverb	ἦ/ἦ#2
φίλος	adjective	φίλος
ἁνήρ	noun	ἀνήρ
,	SENT	,
φίλος	adjective	φίλος
ὄχθος	noun	ὄχθος
·	SENT	:
φίλα	adjective	φίλος
γὰρ	particle	γάρ
κέκευθεν	verb	κεύθω
ἤθη	noun	ἦθος
.	SENT	.
Ἀιδωνεὺς	noun	Ἅιδης/Ἀιδωνεύς
δ̓	adjective	<unknown>
ἀναπομ	unknown	unknown
-	SENT	-
πὸς	noun	ἀναπομπός
ἀνείης	verb	ἀνίημι
,	SENT	,
Ἀιδωνεύς	noun	Ἅιδης/Ἀιδωνεύς
,	SENT	,
θεῖον	adjective	θεῖον/θεῖος
ἀνάκτορα	noun	ἀνάκτωρ/ἀνάκτορον/ἄναξ
Δαριᾶνα	noun	δαρεῖος
.	SENT	.
ἠέ	conjunction	ἤ/ἠέ
.	SENT	.
οὐ	adverb	οὐκ/οὔπως/οὐ
δὲ	particle	μηδέ/δέ/οὐδέ
γὰρ	particle	γάρ
ἄνδρας	noun	ἀνήρ
ποτ̓	adjective	<unknown>
ἀπώλλυ	verb	ἀπόλλυμι
πολεμοφθόροισιν	adjective	πολεμοφθόρος
ἄταις	noun	ἄτη
,	SENT	,
θεομήστωρ	noun	θεομήστωρ
δ̓	adjective	<unknown>
ἐκικλή	unknown	unknown
-	SENT	-
σκετο	verb	κικλήσκω
Πέρσαις	noun	Πέρσης/πέρσης
,	SENT	,
θεομήστωρ	noun	θεομήστωρ
δ̓	adjective	<unknown>
ἔσκεν	verb	εἰμί
,	SENT	,
ἐπεὶ	conjunction	ἐπεί
στρατὸν	noun	στρατός
εὖ	adverb	εὖ
ποδούχει	verb	ποδουχέω
.	SENT	.
ἠέ	conjunction	ἤ/ἠέ
.	SENT	.
βαλήν	noun	βαλλήν
,	SENT	,
ἀρχαῖος	adjective	ἀρχαῖος
βαλήν	noun	βαλλήν
,	SENT	,
ἴθι	verb	εἶμι#2/εἶμι
,	SENT	,
ἱκοῦ	verb	ἱκνέομαι
·	SENT	:
ἔλθ̓	verb	<unknown>
ἐπ̓	verb	<unknown>
ἄκρον	adjective	ἄκρος
κόρυμβον	noun	κόρυμβος
ὄχθου	noun	ὄχθος
,	SENT	,
κροκόβαπτον	adjective	κροκόβαπτος
ποδὸς	noun	πούς
εὔμαριν	noun	εὔμαρις
ἀείρων	adjective	ἄειρος
,	SENT	,
βασιλείου	adjective	βασίλειος
τιάρας	noun	τιάρα
φάλαρον	noun	φάλαρον
πιφαύσκων	verb	πιφαύσκω
.	SENT	.
βάσκε	verb	βάσκω
πάτερ	noun	πατηρ/πάτηρ/πατήρ
ἄκακε	adjective	ἄκακος
Δαριάν	noun	Δαρεῖος
,	SENT	,
οἶ	interjection	οἰ/οἶ
.	SENT	.
ὅπως	conjunction	ὅπως
αἰανῆ	adjective	αἰανής
κλύῃς	verb	κλύω
νέα	noun	ναῦς/νέα
τ̓	adjective	<unknown>
ἄχη	noun	ἄχος
,	SENT	,
δέσποτα	noun	δεσπότης
δεσπότου	noun	δεσπότης
φάνηθι	verb	φαίνω/φανάω
.	SENT	.
Στυγία	adjective	Στύγιος
γάρ	particle	γάρ
τις	pronoun	τις/τίς/τὶς
ἐπ̓	verb	<unknown>
ἀχλὺς	noun	ἀχλύς
πεπόταται	verb	ποτάομαι
·	SENT	:
νεολαία	noun	νεολαία
γὰρ	particle	γάρ
ἤδη	adverb	ἠδή/ἤδη/ἦδη
κατὰ	preposition	κατά
πᾶσ̓	adjective	<unknown>
ὄλωλεν	verb	ὄλλυμι
.	SENT	.
βάσκε	verb	βάσκω
πάτερ	noun	πατηρ/πάτηρ/πατήρ
ἄκακε	adjective	ἄκακος
Δαριάν	noun	Δαρεῖος
,	SENT	,
οἶ	interjection	οἰ/οἶ
.	SENT	.
αἰαῖ	interjection	αἰαῖ
αἰαῖ	interjection	αἰαῖ
·	SENT	:
ὦ	interjection	ὦ
πολύκλαυτε	adjective	πολύκλαυτος/πολύκλαυστος
φίλοισι	adjective	φίλος
θανών	verb	θνήσκω
,	SENT	,
?	SENT	?
τί	pronoun	τις/τίς/τὶς
τάδε	pronoun	ὅδε
δυνάτα	noun	δυνάτης
δυνάτα	noun	δυνάτης
περὶ	preposition	περί
τᾷ	article	ὁ
σᾷ	adjective	σός
δίδυμα	adjective	δίδυμος
[	SENT	[
διαγόεν	unknown	unknown
]	SENT	]
ἁμάρτια	noun	ἁμάρτιον/ἁμάρτημα
;?	unknown	πυνξτ
πᾶσαι	adjective	πᾶς
γᾷ	noun	ὀργή/γῆ
τᾷδ̓	pronoun	<unknown>
ἐξέφθινται	verb	ἐκφθίνω
τρίσκαλμοι	adjective	τρίσκαλμος
νᾶες	noun	ναῦς
ἄναες	adjective	ἄναυς
ἄναες	adjective	ἄναυς
.	SENT	.
ὦ	interjection	ὦ
πιστὰ	adjective	πιστός
πιστῶν	adjective	πιστός
ἥλικές	noun	ἧλιξ
θ̓	adjective	<unknown>
ἥβης	noun	ἥβη
ἐμῆς	adjective	ἐμός
Πέρσαι	noun	Πέρσης/πέρσης
γεραιοί	adjective	γεραιός
,	SENT	,
τίνα	pronoun	ὁς/τις/τίς
πόλις	noun	πόλις/πόόλις
πονεῖ	verb	πονέω/πονέομαι
πόνον	noun	πόνος
;	SENT	;
στένει	verb	στένω
,	SENT	,
κέκοπται	verb	κόπτω
,	SENT	,
καὶ	conjunction	???/καί
χαράσσεται	verb	χαράσσω
πέδον	noun	πέδον
.	SENT	.
λεύσσων	verb	λεύσσω
δ̓	adjective	<unknown>
ἄκοιτιν	noun	ἄκοιτις
τὴν	article	ὁ
ἐμὴν	adjective	ἐμός
τάφου	noun	τάφος
πέλας	adverb	πέλας
ταρβῶ	verb	ταρβέω
,	SENT	,
χοὰς	noun	χοή
δὲ	particle	μηδέ/δέ/οὐδέ
πρευμενὴς	adjective	πρευμενής
ἐδεξάμην	verb	δέχομαι/δείκνυμι
.	SENT	.
ὑμεῖς	pronoun	σύ/ὑμεῖς
δὲ	particle	μηδέ/δέ/οὐδέ
θρηνεῖτ̓	verb	<unknown>
ἐγγὺς	adverb	ἐγγύς
ἑστῶτες	verb	ἵστημι
τάφου	noun	τάφος
καὶ	conjunction	???/καί
ψυχαγωγοῖς	adjective	ψυχαγωγός
ὀρθιάζοντες	verb	ὀρθιάζω
γόοις	noun	γόος
οἰκτρῶς	adverb	οἰκτρός
καλεῖσθέ	verb	καλέω
μ̓	verb	<unknown>
·	SENT	:
ἐστὶ	verb	εἰμί#1/εἰμί
δ̓	verb	<unknown>
οὐκ	adverb	οὐ
εὐέξοδον	adjective	εὐέξοδος
,	SENT	,
ἄλλως	adverb	ἄλλος/ἄλλως
τε	particle	τε/??/οὔτε
πάντως	adverb	πάντως
χοἰ	article	ὁ
κατὰ	preposition	κατά
χθονὸς	noun	χθών
θεοὶ	noun	θεός
λαβεῖν	verb	λαμβάνω
ἀμείνους	adjective	ἀγαθός/ἀμείνων
εἰσὶν	verb	εἰμί#1/εἰμί
ἢ	conjunction	ἤ
μεθιέναι	verb	μεθίημι
.	SENT	.
ὅμως	adverb	ὅμως
δ̓	verb	<unknown>
ἐκείνοις	pronoun	ἐκεῖνος
ἐνδυναστεύσας	verb	ἐνδυναστεύω
ἐγὼ	pronoun	ἐγώ
ἥκω	verb	ἥκω/ἵημι
.	SENT	.
τάχυνε	verb	ταχύνω
δ̓	verb	<unknown>
ὡς	conjunction	ὥς/ὡς
ἄμεμπτος	adjective	ἄμεμπτος
ὦ	interjection	ὦ
χρόνου	noun	χρόνος
.	SENT	.
τί	pronoun	τις/τίς/τὶς
ἐστι	verb	εἰμί#1/εἰμί
Πέρσαις	noun	Πέρσης/πέρσης
νεοχμὸν	adjective	νεοχμός
ἐμβριθὲς	adjective	ἐμβριθής
κακόν	adjective	κακός
·	SENT	:
σέβομαι	verb	σέβομαι
μὲν	particle	μέν
προσιδέσθαι	verb	προσεῖδον
,	SENT	,
σέβομαι	verb	σέβομαι
δ̓	verb	<unknown>
ἀντία	adjective	ἀντίος/ἀντίον
λέξαι	verb	λέγω
σέθεν	pronoun	σύ
ἀρχαίῳ	adjective	ἀρχαῖος
περὶ	preposition	περί
τάρβει	noun	τάρβος
.	SENT	.
ἀλλ̓	verb	<unknown>
ἐπεὶ	conjunction	ἐπεί
κάτωθεν	adverb	κάτωθεν
ἦλθον	verb	ἔρχομαι
σοῖς	adjective	σός
γόοις	noun	γόος
πεπεισμένος	verb	πείθω
,	SENT	,
μή	conjunction	μή
τι	pronoun	τις/τίς/τὶς
μακιστῆρα	noun	μακιστήρ
μῦθον	noun	μῦθος
,	SENT	,
ἀλλὰ	conjunction	ἀλλά/ἀλλὰ
σύντομον	adjective	σύντομος
λέγων	verb	λέγω
εἰπὲ	verb	λέγω/εἶπον
καὶ	conjunction	???/καί
πέραινε	verb	περαίνω
πάντα	adjective	/πα~ς/πᾶς
,	SENT	,
τὴν	article	ὁ
ἐμὴν	adjective	ἐμός
αἰδῶ	noun	αἰδώς/αἰδώ
μεθείς	verb	μεθίημι
.	SENT	.
δίεμαι	verb	δίεμαι
μὲν	particle	μέν
χαρίσασθαι	verb	χαρίζω/χαρίζομαι
,	SENT	,
δίεμαι	verb	δίεμαι
δ̓	verb	<unknown>
ἀντία	adjective	ἀντίος/ἀντίον
φάσθαι	verb	φημί
,	SENT	,
λέξας	verb	λέγω
δύσλεκτα	adjective	δύσλεκτος
φίλοισιν	adjective	φίλος
.	SENT	.
ἀλλ̓	verb	<unknown>
ἐπεὶ	conjunction	ἐπεί
δέος	noun	δέος
παλαιὸν	adjective	παλαιός
σοὶ	pronoun	σύ/σός
φρενῶν	noun	φρήν
ἀνθίσταται	verb	ἀνθίστημι
,	SENT	,
τῶν	article	ὁ/ὅς
ἐμῶν	adjective	ἐμός
λέκτρων	noun	λέκτρον
γεραιὰ	adjective	γεραιός
ξύννομ̓	verb	<unknown>
εὐγενὲς	adjective	εὐγενής
γύναι	noun	γυνή
,	SENT	,
κλαυμάτων	noun	κλαῦμα
λήξασα	verb	λήγω
τῶνδε	pronoun	ὅδε
καὶ	conjunction	???/καί
γόων	noun	γόος
σαφές	adjective	σαφής
τί	pronoun	τις/τίς/τὶς
μοι	pronoun	τις/ἐγώ
λέξον	verb	λέγω
·	SENT	:
ἀνθρώπεια	adjective	ἀνθρώπειος
δ̓	verb	<unknown>
ἄν	adverb	ἀν/ἄν
τοι	pronoun	σύ
πήματ̓	verb	<unknown>
ἂν	adverb	ἀν/ἄν/ἐάν
τύχοι	verb	τυγχάνω
βροτοῖς	noun	βροτός
.	SENT	.
πολλὰ	adjective	πολύς
μὲν	particle	μέν
γὰρ	particle	γάρ
ἐκ	preposition	ἐκ
θαλάσσης	noun	θάλασσα
,	SENT	,
πολλὰ	adjective	πολύς
δ̓	verb	<unknown>
ἐκ	preposition	ἐκ
χέρσου	noun	χέρσος
κακὰ	adjective	κακός
γίγνεται	verb	γίγνομαι
θνητοῖς	adjective	θνητός
,	SENT	,
ὁ	article	ὁ
μάσσων	adjective	μάσσων
βίοτος	noun	βίοτος
ἢν	conjunction	εἄν/ἐάν
ταθῇ	verb	τείνω
,	SENT	,
πρόσω	adverb	πρόσω
.	SENT	.
ὦ	interjection	ὦ
βροτῶν	noun	βροτός
πάντων	adjective	πᾶς
ὑπερσχὼν	verb	ὑπερέχω
ὄλβον	noun	ὄλβος
εὐτυχεῖ	verb	εὐτυχέω
πότμῳ	noun	πότμος
ὡς	conjunction	ὥς/ὡς
ἕως	conjunction	ἑώς/ἕως/ἔως
τ̓	verb	<unknown>
ἔλευσσες	verb	λεύσσω
αὐγὰς	noun	αὐγή
ἡλίου	noun	ἥλιος/ἤλιος
ζηλωτὸς	adjective	ζηλωτός
ὢν	verb	εἰμί#1/εἰμί
βίοτον	noun	βίοτος
εὐαίωνα	noun	εὐαίων
Πέρσαις	noun	Πέρσης/πέρσης
ὡς	conjunction	ὥς/ὡς
θεὸς	noun	θεός
διήγαγες	verb	διάγω
,	SENT	,
νῦν	adverb	νῦν#1/νῦν
τέ	particle	τε
σε	pronoun	σύ
ζηλῶ	verb	ζηλόω/ζηλέω
θανόντα	verb	θνήσκω
,	SENT	,
πρὶν	conjunction	πρίν/πρὶν
κακῶν	adjective	κακός
ἰδεῖν	verb	ἰδέω/εἶδον/ὁράω
βάθος	noun	βάθος
.	SENT	.
πάντα	pronoun	πᾶς
γάρ	particle	γάρ
,	SENT	,
Δαρεῖ̓	noun	<unknown>
ἀκούσῃ	verb	ἀκούω/ἀκέω
μῦθον	noun	μῦθος
ἐν	preposition	ἐν/εἰς
βραχεῖ	adjective	βραχύς
χρόνῳ	noun	χρόνος
.	SENT	.
διαπεπόρθηται	verb	διαπορθέω
τὰ	article	ὁ/τίς
Περσῶν	noun	Πέρσης/Ρέρσης/πέρσης
πράγμαθ̓	verb	<unknown>
,	SENT	,
ὡς	conjunction	ὥς/ὡς
εἰπεῖν	verb	λέγω/εἶπον
ἔπος	noun	ἔπος
.	SENT	.
τίνι	pronoun	τις/τίς/τὶς
τρόπῳ	noun	τρόπος
;	SENT	;
λοιμοῦ	noun	λοιμός
τις	pronoun	τις/τίς/τὶς
ἦλθε	verb	ἔρχομαι
σκηπτὸς	noun	σκηπτός
ἢ	conjunction	ἤ
στάσις	noun	στάσις
πόλει	noun	πόλις
;	SENT	;
οὐδαμῶς	adverb	οὐδαμῶς/οὐδαμός
·	SENT	:
ἀλλ̓	verb	<unknown>
ἀμφ̓	verb	<unknown>
Ἀθήνας	proper	Ἀθῆναι/Ἀθήνευς/Ἀθήνη
πᾶς	pronoun	πᾶς
κατέφθαρται	verb	καταφθείρω
στρατός	noun	στρατός
.	SENT	.
τίς	pronoun	τις/τίς/τὶς
δ̓	verb	<unknown>
ἐμῶν	adjective	ἐμός
ἐκεῖσε	adverb	ἐκεῖσε
παίδων	noun	παῖς
ἐστρατηλάτει	verb	στρατηλατέω/στρατάω
;	SENT	;
φράσον	verb	φράζω
.	SENT	.
θούριος	adjective	θούριος
Ξέρξης	noun	Ξέρξης/Ξήρξης
,	SENT	,
κενώσας	verb	κενόω
πᾶσαν	pronoun	πᾶς
ἠπείρου	noun	ἤπειρος/Ἤπειρος
πλάκα	noun	πλάξ
.	SENT	.
πεζὸς	adjective	πεζός
ἢ	conjunction	ἤ
ναύτης	noun	ναύτης
δὲ	adverb	δέ/οὐ
πεῖραν	noun	πεῖρα
τήνδ̓	adjective	<unknown>
ἐμώρανεν	verb	μωραίνω
τάλας	adjective	τάλας
;	SENT	;
ἀμφότερα	adjective	ἀμφότερος/ἀμφότεροι
·	SENT	:
διπλοῦν	adjective	διπλόος
μέτωπον	noun	μέτωπον
ἦν	verb	είμί/εἰμί#1/εἰμί/ἠμί
δυοῖν	adjective	δύο
στρατευμάτοιν	noun	στράτευμα
.	SENT	.
πῶς	adverb	πως/πῶς
δὲ	particle	μηδέ/δέ/οὐδέ
καὶ	conjunction	???/καί
στρατὸς	noun	στρατός
τοσόσδε	adjective	τοσόσδε
πεζὸς	adjective	πεζός
ἤνυσεν	verb	ἀνύω
περᾶν	verb	περάω
;	SENT	;
μηχαναῖς	noun	μηχανή
ἔζευξεν	verb	ζεύγνυμι
Ἕλλης	proper	Ἕλλη
πορθμόν	noun	πορθμός
,	SENT	,
ὥστ̓	adverb	<unknown>
ἔχειν	verb	ἔχω
πόρον	noun	πόρος
.	SENT	.
καὶ	conjunction	???/καί
τόδ̓	noun	<unknown>
ἐξέπραξεν	verb	ἐκπράσσω
,	SENT	,
ὥστε	conjunction	ὥστε
Βόσπορον	noun	βόσπορος
κλῇσαι	verb	κλῄζω/κλείω
μέγαν	adjective	μέγας
·	SENT	:
ὧδ̓	adverb	<unknown>
ἔχει	verb	ἐχώ/ἔχω/χέω/χάω
·	SENT	:
γνώμης	noun	γνώμη
δέ	particle	δέ/οὐδέ
πού	adverb	πού
τις	pronoun	τις/τίς/τὶς
δαιμόνων	noun	δαίμων
ξυνήψατο	verb	συνάπτω
.	SENT	.
φεῦ	interjection	φεῦ
,	SENT	,
μέγας	adjective	μέγας
τις	pronoun	τις/τίς/τὶς
ἦλθε	verb	ἔρχομαι
δαίμων	noun	δαίμων
,	SENT	,
ὥστε	conjunction	ὥστε
μὴ	adverb	μή/μὴ
φρονεῖν	verb	φρονέω
καλῶς	adverb	καλῶς/καλός
.	SENT	.
ὡς	conjunction	ὥς/ὡς
ἰδεῖν	verb	ἰδέω/εἶδον/ὁράω
τέλος	noun	τέλος
πάρεστιν	verb	πάρειμι/πάρειμι#1
οἷον	adjective	οἷος
ἤνυσεν	verb	ἀνύω
κακόν	adjective	κακός
.	SENT	.
καὶ	conjunction	???/καί
τί	pronoun	τις/τίς/τὶς
δὴ	adverb	δή
πράξασιν	verb	πράσσω
αὐτοῖς	pronoun	αὐτός
ὧδ̓	adverb	<unknown>
ἐπιστενάζετε	verb	ἐπιστενάζω
;	SENT	;
ναυτικὸς	adjective	ναυτικός
στρατὸς	noun	στρατός
κακωθεὶς	verb	κακόω
πεζὸν	adjective	πεζός
ὤλεσε	verb	ὄλλυμι
στρατόν	noun	στρατός
.	SENT	.
ὧδε	adverb	ὧδε
παμπήδην	adverb	παμπήδην
δὲ	adverb	δέ/οὐ
λαὸς	noun	λαός
πᾶς	adjective	πᾶς
κατέφθαρται	verb	καταφθείρω
δορί	noun	δόρυ/δορίς
;	SENT	;
πρὸς	preposition	πρός
τάδ̓	verb	<unknown>
ὡς	conjunction	ὥς/ὡς
Σούσων	proper	Σοῦσος/Σοῦσα
μὲν	adverb	μέν
ἄστυ	noun	ἄστυ
πᾶν	adjective	πᾶς
κενανδρίαν	noun	κενανδρία
στένει	verb	στένω
.	SENT	.
ὦ	interjection	ὦ
πόποι	interjection	πόποι
κεδνῆς	adjective	κεδνός
ἀρωγῆς	noun	ἀρωγή
κἀπικουρίας	noun	ἐπικουρία
στρατοῦ	noun	στρατός
.	SENT	.
Βακτρίων	adjective	Βάκτριος
δ̓	adjective	<unknown>
ἔρρει	verb	ῥέω/ἔρρω
πανώλης	adjective	πανώλης
δῆμος	noun	δῆμος
,	SENT	,
οὐ	adverb	οὐκ/οὔπως/οὐ
δέ	particle	δέ/οὐδέ
τις	pronoun	τις/τίς/τὶς
γέρων	noun	γέρων
.	SENT	.
ὦ	interjection	ὦ
μέλεος	adjective	μέλεος
,	SENT	,
οἵαν	adjective	οἷος
ἄῤ	adjective	<unknown>
ἥβην	noun	ἥβη
ξυμμάχων	noun	σύμμαχος
ἀπώλεσεν	verb	ἀπόλλυμι
.	SENT	.
μονάδα	noun	μονάς
δὲ	particle	μηδέ/δέ/οὐδέ
Ξέρξην	noun	Ξέρξης
ἔρημόν	adjective	ἐρῆμος
φασιν	verb	φημί
οὐ	adverb	οὐκ/οὔπως/οὐ
πολλῶν	adjective	πολύς
μέτα	verb	μέτειμι/μέτα
-	SENT	-
πῶς	adverb	πως/πῶς
τε	particle	τε/??/οὔτε
δὴ	adverb	δή
καὶ	conjunction	???/καί
ποῖ	adverb	ποι/ποῖ
τελευτᾶν	verb	τελευτάω
;	SENT	;
ἄσμενον	adjective	ἄσμενος
μολεῖν	verb	βλώσκω
γέφυραν	noun	γέφυρα
γαῖν	noun	γῆ
δυοῖν	adjective	δύο
ζευκτηρίαν	adjective	ζευκτήριος
.	SENT	.
καὶ	conjunction	???/καί
πρὸς	preposition	πρός
ἤπειρον	noun	ἤπειρος
σεσῶσθαι	verb	σώζω
τήνδε	pronoun	ὅδε
,	SENT	,
τοῦτ̓	verb	<unknown>
ἐτήτυμον	adjective	ἐτήτυμος
;	SENT	;
ναί	interjection	ναί
·	SENT	:
λόγος	noun	λόγος
κρατεῖ	verb	κρατέω
σαφηνὴς	adjective	σαφηνής
τοῦτό	pronoun	οὗτος
γ̓	verb	<unknown>
,	SENT	,
οὐ	adverb	οὐκ/οὔπως/οὐ
δ̓	verb	<unknown>
ἔνι	preposition	ἐν
στάσις	noun	στάσις
.	SENT	.
φεῦ	interjection	φεῦ
,	SENT	,
ταχεῖά	adjective	ταχύς
γ̓	adjective	<unknown>
ἦλθε	verb	ἔρχομαι
χρησμῶν	noun	χρησμός
πρᾶξις	noun	πρᾶξις
,	SENT	,
ἐς	preposition	εἰς
δὲ	particle	μηδέ/δέ/οὐδέ
παῖδ̓	verb	<unknown>
ἐμὸν	adjective	ἐμός
Ζεὺς	noun	Ζεύς/ζεύς
ἀπέσκηψεν	verb	ἀποσκήπτω
τελευτὴν	noun	τελευτή
θεσφάτων	adjective	θέσφατος
·	SENT	:
ἐγὼ	pronoun	ἐγώ
δέ	particle	δέ/οὐδέ
που	adverb	ποῦ/πού
διὰ	preposition	διά
μακροῦ	adjective	μακρός
χρόνου	noun	χρόνος
τάδ̓	verb	<unknown>
ηὔχουν	verb	αὐχέω
ἐκτελευτήσειν	verb	ἐκτελευτάω
θεούς	noun	θεός
·	SENT	:
ἀλλ̓	verb	<unknown>
ὅταν	adverb	ὅταν
σπεύδῃ	verb	σπεύδω
τις	pronoun	τις/τίς/τὶς
αὐτός	adjective	αὐτός
,	SENT	,
χὠ	article	ὁ
θεὸς	noun	θεός
συνάπτεται	verb	συνάπτω
.	SENT	.
νῦν	adverb	νῦν#1/νῦν
κακῶν	adjective	κακός
ἔοικε	verb	ἔοικα
πηγὴ	noun	πηγή
πᾶσιν	adjective	πάν/πᾶς
ηὑρῆσθαι	verb	εὑρίσκω
φίλοις	adjective	φίλος
.	SENT	.
παῖς	noun	παῖς
δ̓	verb	<unknown>
ἐμὸς	pronoun	ἐμός
τάδ̓	verb	<unknown>
οὐ	adverb	οὐκ/οὔπως/οὐ
κατειδὼς	verb	κάτοιδα
ἤνυσεν	verb	ἀνύω
νέῳ	adjective	νέος
θράσει	noun	θράσις/θράσος
·	SENT	:
ὅστις	pronoun	ὅστις
Ἑλλήσποντον	noun	Ἑλλήσποντος
ἱρὸν	adjective	ἱερός/ἱρός
δοῦλον	noun	δοῦλος
ὣς	adverb	ὥς/ὡς
δεσμώμασιν	noun	δέσμωμα/δεσμωμα
ἤλπισε	verb	ἐλπίζω
σχήσειν	verb	ἔχω/σχάω
ῥέοντα	verb	ῥέω
,	SENT	,
Βόσπορον	noun	βόσπορος
ῥόον	noun	ῥόον/ῥόος
θεοῦ	noun	θέος/θεός
·	SENT	:
καὶ	conjunction	???/καί
πόρον	noun	πόρος
μετερρύθμιζε	verb	μεταρρυθμίζω
,	SENT	,
καὶ	conjunction	???/καί
πέδαις	noun	πέδη
σφυρηλάτοις	adjective	σφυρήλατος
περιβαλὼν	verb	περιβάλλω
πολλὴν	adjective	πολύς
κέλευθον	noun	κέλευθος
ἤνυσεν	verb	ἀνύω
πολλῷ	adjective	πολύς
στρατῷ	noun	στρατός
,	SENT	,
θνητὸς	adjective	θνητός
ὢν	verb	εἰμί#1/εἰμί
θεῶν	noun	θέος/θεεός/θέα/θεά/θεός/θεὸς
τε	conjunction	τε/ὅτε
πάντων	pronoun	πᾶς
ᾤετ̓	verb	<unknown>
,	SENT	,
οὐκ	adverb	οὐ
εὐβουλίᾳ	noun	εὐβουλία
,	SENT	,
καὶ	conjunction	???/καί
Ποσειδῶνος	noun	Ποσειδῶν/ποσειδῶν
κρατήσειν	verb	κρατέω
.	SENT	.
πῶς	adverb	πως/πῶς
τάδ̓	verb	<unknown>
οὐ	adverb	οὐκ/οὔπως/οὐ
νόσος	noun	νόσος
φρενῶν	noun	φρήν
εἶχε	verb	ἔχω
παῖδ̓	verb	<unknown>
ἐμόν	adjective	ἐμός
;	SENT	;
δέδοικα	verb	δείδω
μὴ	particle	μή
πολὺς	adjective	πολύς
πλούτου	noun	πλοῦτος
πόνος	noun	πόνος
οὑμὸς	adjective	ἐμός/ὑμός
ἀνθρώποις	noun	ἄνθρωπος
γένηται	verb	γίγνομαι
τοῦ	article	ὁ/ὅς/τὁ/ὀ
φθάσαντος	verb	φθάνω/φθάζω
ἁρπαγή	noun	ἁρπαγή
.	SENT	.
ταῦτά	pronoun	οὗτος
τοι	particle	τοι
κακοῖς	adjective	κακός
ὁμιλῶν	verb	ὁμιλέω
ἀνδράσιν	noun	ἀνήρ
διδάσκεται	verb	διδάσκω
θούριος	adjective	θούριος
Ξέρξης	noun	Ξέρξης/Ξήρξης
·	SENT	:
λέγουσι	verb	λέγω
δ̓	verb	<unknown>
ὡς	conjunction	ὥς/ὡς
σὺ	pronoun	σύ
μὲν	adverb	μέν
μέγαν	adjective	μέγας
τέκνοις	noun	τέκνον
πλοῦτον	noun	πλοῦτος
ἐκτήσω	verb	κτάομαι/κτέομαι
ξὺν	preposition	σύν
αἰχμῇ	noun	αἰχμή
,	SENT	,
τὸν	article	ὁ/τὸν
δ̓	adjective	<unknown>
ἀνανδρίας	noun	ἀνανδρία
ὕπο	preposition	ὑπό
ἔνδον	adverb	ἔνδον
αἰχμάζειν	verb	αἰχμάζω
,	SENT	,
πατρῷον	adjective	πατρῷος
δ̓	adjective	<unknown>
ὄλβον	noun	ὄλβος
οὐδὲν	adjective	οὐδείς
αὐξάνειν	verb	αὐξάνω
.	SENT	.
τοιάδ̓	verb	<unknown>
ἐξ	preposition	ἐκ
ἀνδρῶν	noun	ἀνήρ
ὀνείδη	noun	ὄνειδος
πολλάκις	adverb	πολλάκις
κλύων	verb	κλύω
κακῶν	adjective	κακός
τήνδ̓	verb	<unknown>
ἐβούλευσεν	verb	βουλεύω
κέλευθον	noun	κέλευθος
καὶ	conjunction	???/καί
στράτευμ̓	verb	<unknown>
ἐφ̓	verb	<unknown>
Ἑλλάδα	noun	Ἑλλάς/ʽἑλλάς
.	SENT	.
τοιγάρ	particle	τοιγάρ
σφιν	pronoun	σφεῖς
ἔργον	noun	ἔργον
ἐστὶν	verb	εἰμί#1/εἰμί
ἐξειργασμένον	verb	ἐξεργάζομαι
μέγιστον	adjective	μέγας
,	SENT	,
ἀείμνηστον	adjective	ἀείμνηστος
,	SENT	,
οἷον	adjective	οἷος
οὐδέπω	adverb	οὐδέπω
τόδ̓	verb	<unknown>
ἄστυ	noun	ἄστυ
Σούσων	proper	Σοῦσος/Σοῦσα
ἐξεκείνωσεν	verb	ἐκκενόω
πεσόν	verb	πίπτω
,	SENT	,
ἐξ	preposition	ἐκ
οὗτε	pronoun	ὅστε
τιμὴν	noun	τιμή
Ζεὺς	noun	Ζεύς/ζεύς
ἄναξ	noun	ἄναξ
τήνδ̓	adjective	<unknown>
ὤπασεν	verb	ὀπάζω
,	SENT	,
ἕν̓	verb	<unknown>
ἄνδῤ	verb	<unknown>
ἁπάσης	adjective	ἅπας
Ἀσίδος	adjective	Ἀσίς
μηλοτρόφου	adjective	μηλοτρόφος
ταγεῖν	verb	ταγέω
,	SENT	,
ἔχοντα	verb	ἔχω
σκῆπτρον	noun	σκῆπτρον
εὐθυντήριον	adjective	εὐθυντήριος
.	SENT	.
Μῆδος	noun	Μῆδος
γὰρ	particle	γάρ
ἦν	verb	είμί/εἰμί#1/εἰμί/ἠμί
ὁ	article	ὁ
πρῶτος	adjective	πρότερος/πρῶτος
ἡγεμὼν	noun	ἡγεμών
στρατοῦ	noun	στρατός
·	SENT	:
ἄλλος	adjective	ἄλλος
δ̓	verb	<unknown>
ἐκείνου	pronoun	ἐκεῖνος/ἐκείνος/εκεῖνος
παῖς	noun	παῖς
τόδ̓	noun	<unknown>
ἔργον	noun	ἔργον
ἤνυσεν	verb	ἀνύω
·	SENT	:
φρένες	noun	φρήν
γὰρ	particle	γάρ
αὐτοῦ	pronoun	αὐτοός/αὐτός
θυμὸν	noun	θυμός
ᾠακοστρόφουν	verb	οἰακοστροφέω
.	SENT	.
τρίτος	adjective	τρίτος
δ̓	adjective	<unknown>
ἀπ̓	verb	<unknown>
αὐτοῦ	pronoun	αὐτοός/αὐτός
Κῦρος	noun	ξψρυς/κῦρος/Κῦρος/Kῦρος
,	SENT	,
εὐδαίμων	adjective	εὐδαίμων
ἀνήρ	noun	ἀνήρ
,	SENT	,
ἄρξας	verb	ἄρχω
ἔθηκε	verb	τίθημι
πᾶσιν	pronoun	πᾶς
εἰρήνην	noun	εἰρήνη
φίλοις	adjective	φίλος
·	SENT	:
Λυδῶν	noun	Λυδός
δὲ	particle	μηδέ/δέ/οὐδέ
λαὸν	noun	λαός
καὶ	conjunction	???/καί
Φρυγῶν	noun	Φρύξ
ἐκτήσατο	verb	κτάομαι/κτέομαι
,	SENT	,
Ἰωνίαν	noun	Ἰωνία
τε	particle	τε/??/οὔτε
πᾶσαν	pronoun	πᾶς
ἤλασεν	verb	ἐλαύνω
βίᾳ	noun	βία
.	SENT	.
θεὸς	noun	θεός
γὰρ	particle	γάρ
οὐκ	adverb	οὐ
ἤχθηρεν	verb	ἐχθαίρω
,	SENT	,
ὡς	conjunction	ὥς/ὡς
εὔφρων	adjective	εὔφρων
ἔφυ	verb	φύω
.	SENT	.
Κύρου	noun	Κῦρος/Κύρης
δὲ	particle	μηδέ/δέ/οὐδέ
παῖς	noun	παῖς
τέταρτος	adjective	τέταρτος
ηὔθυνε	verb	εὐθύνω
στρατόν	noun	στρατός
.	SENT	.
πέμπτος	adjective	πέμπτος
δὲ	particle	μηδέ/δέ/οὐδέ
Μάρδος	adjective	Μάρδος
ἦρξεν	verb	ἔρδω/ἄρχω
,	SENT	,
αἰσχύνη	noun	αἰσχύνη
πάτρᾳ	noun	πάτρη/φράτρα/πάτρα
θρόνοισί	noun	θρόνος
τ̓	verb	<unknown>
ἀρχαίοισι	adjective	ἀρχαῖος
·	SENT	:
τὸν	article	ὁ/τὸν
δὲ	adverb	δέ/οὐ
σὺν	preposition	σύν
δόλῳ	noun	δόλος
Ἀρταφρένης	proper	Ἀρταφρένης
ἔκτεινεν	verb	κτείνω/ἐκτείνω
ἐσθλὸς	adjective	ἐσθλός
ἐν	preposition	ἐν/εἰς
δόμοις	noun	δόμος
,	SENT	,
ξὺν	preposition	σύν
ἀνδράσιν	noun	ἀνήρ
φίλοισιν	adjective	φίλος
,	SENT	,
οἷς	pronoun	ὁ/ὅς
τόδ̓	noun	<unknown>
ἦν	verb	είμί/εἰμί#1/εἰμί/ἠμί
χρέος	noun	χρέος
.	SENT	.
[ἕκτος	adjective	ἕκτος
δὲ	particle	μηδέ/δέ/οὐδέ
Μάραφις	noun	Μάραφις
,	SENT	,
ἕβδομος	adjective	ἕβδομος
δ̓	verb	<unknown>
Ἀρταφρένης	proper	Ἀρταφρένης
.]	SENT	.]
κἀγὼ	pronoun	ἐγώ
πάλου	noun	πᾶλος/πάλος
τ̓	adjective	<unknown>
ἔκυρσα	verb	κυρέω
τοῦπερ	pronoun	τις/τίς/ὅσπερ
ἤθελον	verb	ἐθέλω
,	SENT	,
κἀπεστράτευσα	verb	ἐπιστρατεύω
πολλὰ	adjective	πολύς
σὺν	preposition	σύν
ἀλλ̓	adjective	<unknown>
οὐ	adverb	οὐκ/οὔπως/οὐ
κακὸν	adjective	κακός
τοσόνδε	pronoun	τοσόσδε
προσέβαλον	verb	προσβάλλω/προσδαίω
πόλει	noun	πόλις
.	SENT	.
Ξέρξης	noun	Ξέρξης/Ξήρξης
δ̓	verb	<unknown>
ἐμὸς	adjective	ἐμός
παῖς	noun	παῖς
ὢν	verb	εἰμί#1/εἰμί
νέος	adjective	νέος
νέα	noun	ναῦς/νέα
φρονεῖ	verb	φρονέω
,	SENT	,
κοὐ	adverb	οὐ
μνημονεύει	verb	μνημονεύω
τὰς	article	ὁ
ἐμὰς	adjective	ἐμός
ἐπιστολάς	noun	ἐπιστολή
·	SENT	:
εὖ	adverb	εὖ
γὰρ	particle	γάρ
σαφῶς	adverb	σαφής/σαφῶς
τόδ̓	noun	<unknown>
ἴστ̓	verb	<unknown>
,	SENT	,
ἐμοὶ	pronoun	ἐμός/ἐγώ
ξυνήλικες	noun	συνῆλιξ
,	SENT	,
ἅπαντες	adjective	ἅπας
ἡμεῖς	pronoun	ἐγώ/ἡμεῖς
,	SENT	,
οἳ	pronoun	ὁ/ὅς/ἕ
κράτη	noun	κράτος
τάδ̓	verb	<unknown>
ἔσχομεν	verb	ἔχω
,	SENT	,
οὐκ	adverb	οὐ
ἂν	particle	ἄν
φανεῖμεν	verb	φαίνω/φανάω
πήματ̓	adjective	<unknown>
ἔρξαντες	verb	ἔρδω
τόσα	adjective	τόσος
.	SENT	.
τί	pronoun	τις/τίς/τὶς
οὖν	particle	οὖν
,	SENT	,
ἄναξ	noun	ἄναξ
Δαρεῖε	noun	Δαρεῖος
,	SENT	,
ποῖ	adverb	ποι/ποῖ
καταστρέφεις	verb	καταστρέφω
λόγων	noun	λογός/λόγος
τελευτήν	noun	τελευτή
;	SENT	;
πῶς	adverb	πως/πῶς
ἂν	particle	ἄν
ἐκ	preposition	ἐκ
τούτων	pronoun	οὗτος
ἔτι	adverb	ἔτι
πράσσοιμεν	verb	πράσσω
ὡς	conjunction	ὥς/ὡς
ἄριστα	adjective	ἄριστος/ἀγαθός
Περσικὸς	adjective	Περσικός
λεώς	noun	λαός
;	SENT	;
εἰ	conjunction	εἰ
μὴ	adverb	μή/μὴ
στρατεύοισθ̓	verb	<unknown>
ἐς	preposition	εἰς
τὸν	article	ὁ/τὸν
Ἑλλήνων	noun	Ἕλλην/῞ἕλλην
τόπον	noun	τόπος
,	SENT	,
μη	particle	μή/μηδέ
δ̓	verb	<unknown>
εἰ	conjunction	εἰ
στράτευμα	noun	στράτευμα
πλεῖον	adjective	πλείων/πλέως/πολύς
τὸ	article	ὁ
Μηδικόν	adjective	Μηδικός
.	SENT	.
αὐτὴ	pronoun	οὗτος/αὐτός
γὰρ	adverb	γάρ
ἡ	article	ὁ
γῆ	noun	Γαῖα/γῆ
ξύμμαχος	adjective	σύμμαχος
κείνοις	adjective	ἐκεῖνος/κεῖνος
πέλει	verb	πελάω/πέλω
.	SENT	.
πῶς	adverb	πως/πῶς
τοῦτ̓	adjective	<unknown>
ἔλεξας	verb	λέγω
,	SENT	,
τίνι	pronoun	τις/τίς/τὶς
τρόπῳ	noun	τρόπος
δὲ	adverb	δέ/οὐ
συμμαχεῖ	verb	συμμαχέω/συμμάχομαι
;	SENT	;
κτείνουσα	verb	κτείνω
λιμῷ	noun	λιμός
τοὺς	article	ὁ
ὑπερπόλλους	adjective	ὑπέρπολυς
ἄγαν	adverb	ἄγαν
.	SENT	.
ἀλλ̓	verb	<unknown>
εὐσταλῆ	adjective	εὐσταλής
τοι	pronoun	σύ
λεκτὸν	adjective	λεκτός
ἀροῦμεν	verb	αἴρω/ἀρόω/ἀείρω
στόλον	noun	στόλος
.	SENT	.
ἀλλ̓	verb	<unknown>
οὐ	adverb	οὐκ/οὔπως/οὐ
δ̓	verb	<unknown>
ὁ	article	ὁ
μείνας	verb	μένω
νῦν	adverb	νῦν#1/νῦν
ἐν	preposition	ἐν/εἰς
Ἑλλάδος	noun	Ἑλλάς/ʽἑλλάς
τόποις	noun	τόπος
στρατὸς	noun	στρατός
κυρήσει	verb	κυρέω
νοστίμου	adjective	νόστιμος
σωτηρίας	noun	σωτηρία
.	SENT	.
πῶς	adverb	πως/πῶς
εἶπας	verb	λέγω/εἶπον
;	SENT	;
οὐ	adverb	οὐκ/οὔπως/οὐ
γὰρ	particle	γάρ
πᾶν	adjective	πᾶς
στράτευμα	noun	στράτευμα
βαρβάρων	noun	βάρβαρος
περᾷ	verb	περάω
τὸν	article	ὁ/τὸν
Ἕλλης	proper	Ἕλλη
πορθμὸν	noun	πορθμός
Εὐρώπης	noun	Εὐρώπης/Εὐρώπη/εὐρώπη
ἄπο	preposition	ἀπό
;	SENT	;
παῦροι	adjective	παῦρος
γε	particle	γε
πολλῶν	adjective	πολύς
,	SENT	,
εἴ	conjunction	εἰ
τι	pronoun	τις/τίς/τὶς
πιστεῦσαι	verb	πιστόω/πιστεύω
θεῶν	noun	θέος/θεεός/θέα/θεά/θεός/θεὸς
χρὴ	verb	χρή/χρὴ
θεσφάτοισιν	adjective	θέσφατος
,	SENT	,
ἐς	preposition	εἰς
τὰ	article	ὁ/τίς
νῦν	adverb	νῦν#1/νῦν
πεπραγμένα	verb	πράσσω
βλέψαντα	verb	βλέπω
·	SENT	:
συμβαίνει	verb	συμβαίνω
γὰρ	particle	γάρ
οὐ	adverb	οὐκ/οὔπως/οὐ
τὰ	article	ὁ/τίς
μέν	adverb	μέν
,	SENT	,
τὰ	article	ὁ/τίς
δ̓	adjective	<unknown>
οὔ	adverb	οὔπως/οὔτι/οὔτε/οὐ
.	SENT	.
κεἴπερ	conjunction	εἴπερ
τάδ̓	verb	<unknown>
ἐστί	verb	εἰμί#1/εἰμί
,	SENT	,
πλῆθος	noun	πλῆθος
ἔκκριτον	adjective	ἔκκριτος
στρατοῦ	noun	στρατός
λείπει	verb	λείπω
κεναῖσιν	adjective	κενός
ἐλπίσιν	noun	ἐλπίς
πεπεισμένος	verb	πείθω
.	SENT	.
μίμνουσι	verb	μίμνω
δ̓	verb	<unknown>
ἔνθα	adverb	ἔνθα
πεδίον	noun	πεδίον
Ἀσωπὸς	noun	Ἀσωπός
ῥοαῖς	noun	ῥοή
ἄρδει	verb	ἄρδω
,	SENT	,
φίλον	adjective	φίλος
πίασμα	noun	πίασμα
Βοιωτῶν	noun	βοιωτός/Βοιωτός
χθονί	noun	χθών
·	SENT	:
οὗ	pronoun	ὁς/ὅς/ἕ
σφιν	pronoun	σφεῖς
κακῶν	adjective	κακός
ὕψιστ̓	verb	<unknown>
ἐπαμμένει	verb	ἐπαναμένω/ἐπαμμένω
παθεῖν	verb	πάσχω
,	SENT	,
ὕβρεως	noun	ὕβρις
ἄποινα	noun	ἄποινα
κἀθέων	adjective	ἄθεος
φρονημάτων	noun	φρόνημα
·	SENT	:
οἳ	pronoun	ὁ/ὅς/ἕ
γῆν	noun	Γαῖα/γῆ
μολόντες	verb	βλώσκω
Ἑλλάδ̓	verb	<unknown>
οὐ	adverb	οὐκ/οὔπως/οὐ
θεῶν	noun	θέος/θεεός/θέα/θεά/θεός/θεὸς
βρέτη	noun	βρέτας/βρέτος
ᾐδοῦντο	verb	αἰδέομαι
συλᾶν	noun	σύλη
οὐ	adverb	οὐκ/οὔπως/οὐ
δὲ	adverb	δέ/οὐ
πιμπράναι	verb	πίμπρημι
νεώς	noun	ναῦς/νεώς/ναός
·	SENT	:
βωμοὶ	noun	βωμός
δ̓	verb	<unknown>
ἄιστοι	adjective	ἄιστος
,	SENT	,
δαιμόνων	noun	δαίμων
θ̓	adjective	<unknown>
ἱδρύματα	noun	ἵδρυμα
πρόρριζα	adjective	πρόρριζος
φύρδην	adverb	φύρδην
ἐξανέστραπται	verb	ἐξαναστρέφω
βάθρων	noun	βάθρον
.	SENT	.
τοιγὰρ	particle	τοιγάρ
κακῶς	adverb	κακῶς/κακός
δράσαντες	verb	δράω
οὐκ	adverb	οὐ
ἐλάσσονα	adjective	ἐλάσσων
πάσχουσι	verb	πάσχω
,	SENT	,
τὰ	article	ὁ/τίς
δὲ	adverb	δέ/οὐ
μέλλουσι	verb	μέλλω
,	SENT	,
κοὐδέπω	adverb	οὐδέπω
κακῶν	adjective	κακός
κρηνὶς	noun	κρηνίς
ἀπέσβηκ̓	verb	<unknown>
ἀλλ̓	adjective	<unknown>
ἔτ̓	verb	<unknown>
ἐκπιδύεται	verb	ἐκπιδύομαι
.	SENT	.
τόσος	adjective	τόσος
γὰρ	particle	γάρ
ἔσται	verb	εἰμί#1/εἰμί
πέλανος	noun	πέλανος
αἱματοσφαγὴς	adjective	αἱματοσφαγής
πρὸς	preposition	πρός
γῇ	noun	Γαῖα/γῆ
Πλαταιῶν	noun	Πλάταια
Δωρίδος	noun	Δωρίς/δωρίς
λόγχης	noun	λόγχη
ὕπο	preposition	ὑπό
·	SENT	:
θῖνες	noun	θίς
νεκρῶν	adjective	νεκρός
δὲ	adverb	δέ/οὐ
καὶ	conjunction	???/καί
τριτοσπόρῳ	adjective	τριτόσπορος
γονῇ	noun	γονεύς/γονή
ἄφωνα	adjective	ἄφωνος
σημανοῦσιν	verb	σημαίνω
ὄμμασιν	noun	ὄμμα
βροτῶν	noun	βροτός
ὡς	conjunction	ὥς/ὡς
οὐχ	adverb	οὐ
ὑπέρφευ	adverb	ὑπέρφευ
θνητὸν	adjective	θνητός
ὄντα	verb	εἰμί#1/εἰμί/εἴμι
χρὴ	verb	χρή/χρὴ
φρονεῖν	verb	φρονέω
.	SENT	.
ὕβρις	noun	ὕβρις
γὰρ	particle	γάρ
ἐξανθοῦσ̓	verb	<unknown>
ἐκάρπωσεν	verb	καρπόω
στάχυν	noun	στάχυς
ἄτης	noun	ἄτη
,	SENT	,
ὅθεν	adverb	ὅθεν
πάγκλαυτον	adjective	πάγκλαυστος/πάγκλαυτος
ἐξαμᾷ	verb	ἐξαμάω
θέρος	noun	θέρος
.	SENT	.
τοιαῦθ̓	verb	<unknown>
ὁρῶντες	verb	ὁράω
τῶνδε	pronoun	ὅδε
τἀπιτίμια	noun	ἐπιτίμιον
μέμνησθ̓	verb	<unknown>
Ἀθηνῶν	noun	̓ἀθῆναι/Ἀθῆναι
Ἑλλάδος	noun	Ἑλλάς/ʽἑλλάς
τε	particle	τε/??/οὔτε
,	SENT	,
μη	particle	μή/μηδέ
δέ	particle	δέ/οὐδέ
τις	pronoun	τις/τίς/τὶς
ὑπερφρονήσας	verb	ὑπερφρονέω
τὸν	article	ὁ/τὸν
παρόντα	verb	πάρειμι
δαίμονα	noun	δαίμων
ἄλλων	adjective	ἄλλος
ἐρασθεὶς	verb	ἔραμαι
ὄλβον	noun	ὄλβος
ἐκχέῃ	verb	ἐκχέω
μέγαν	adjective	μέγας
.	SENT	.
Ζεύς	noun	Ζεύς/ζεύς
τοι	particle	τοι
κολαστὴς	noun	κολαστής
τῶν	article	ὁ/ὅς
ὑπερκόμπων	adjective	ὑπέρκομπος
ἄγαν	adverb	ἄγαν
φρονημάτων	noun	φρόνημα
ἔπεστιν	verb	ἔπειμι
,	SENT	,
εὔθυνος	noun	εὔθυνος
βαρύς	adjective	βαρύς
.	SENT	.
πρὸς	preposition	πρός
ταῦτ̓	verb	<unknown>
ἐκεῖνον	adjective	ἐκεῖνος
,	SENT	,
σωφρονεῖν	verb	σωφρονέω
κεχρημένον	verb	χράω
,	SENT	,
πινύσκετ̓	verb	<unknown>
εὐλόγοισι	adjective	εὔλογος
νουθετήμασιν	noun	νουθέτημα
,	SENT	,
λῆξαι	verb	λήγω
θεοβλαβοῦνθ̓	verb	<unknown>
ὑπερκόμπῳ	adjective	ὑπέρκομπος
θράσει	noun	θράσις/θράσος
.	SENT	.
σὺ	pronoun	σύ
δ̓	verb	<unknown>
,	SENT	,
ὦ	interjection	ὦ
γεραιὰ	adjective	γεραιός
μῆτερ	noun	μήτηρ
ἡ	article	ὁ
Ξέρξου	noun	Ξέρξης/ξέρξης
φίλη	adjective	φίλος
,	SENT	,
ἐλθοῦσ̓	verb	<unknown>
ἐς	preposition	εἰς
οἴκους	noun	οἶκος
κόσμον	noun	κόσμος
ὅστις	pronoun	ὅστις
εὐπρεπὴς	adjective	εὐπρεπής
λαβοῦσ̓	verb	<unknown>
ὑπαντίαζε	verb	ὑπαντιάζω
παιδί	noun	παῖς
.	SENT	.
πάντα	pronoun	πᾶς
γὰρ	particle	γάρ
κακῶν	adjective	κακός
ὑπ̓	verb	<unknown>
ἄλγους	noun	ἄλγος
λακίδες	noun	λακίς
ἀμφὶ	preposition	ἀμφί
σώματι	noun	σῶμα
στημορραγοῦσι	verb	στημορραγέω
ποικίλων	adjective	ποικίλος
ἐσθημάτων	noun	ἔσθημα
.	SENT	.
ἀλλ̓	verb	<unknown>
αὐτὸν	pronoun	αὐτός
εὐφρόνως	adverb	εὐφρόνως
σὺ	pronoun	σύ
πράυνον	verb	πραύνω
λόγοις	noun	λόγος
·	SENT	:
μόνης	adjective	μόνος
γάρ	particle	γάρ
,	SENT	,
οἶδα	verb	εἴδω/οἶδα
,	SENT	,
σοῦ	pronoun	σύ/σός
κλύων	verb	κλύω
ἀνέξεται	verb	ἀνέχω
.	SENT	.
ἐγὼ	pronoun	ἐγώ
δ̓	adjective	<unknown>
ἄπειμι	verb	ἄπειμι/ἄπειμι#1
γῆς	noun	Γαῖα/γῆ
ὑπὸ	preposition	ὑπό
ζόφον	noun	ζόφος
κάτω	adverb	κάτω
.	SENT	.
ὑμεῖς	pronoun	σύ/ὑμεῖς
δέ	particle	δέ/οὐδέ
,	SENT	,
πρέσβεις	noun	πρέσβυς/πρεσβεύς/πρέσβις
,	SENT	,
χαίρετ̓	verb	<unknown>
,	SENT	,
ἐν	preposition	ἐν/εἰς
κακοῖς	adjective	κακός
ὅμως	adverb	ὅμως
ψυχῇ	noun	ψυχή
διδόντες	verb	δίδωμι
ἡδονὴν	noun	ἡδονά/ἡδονή
καθ̓	verb	<unknown>
ἡμέραν	noun	ἡμέρα
,	SENT	,
ὡς	conjunction	ὥς/ὡς
τοῖς	article	ὁ
θανοῦσι	verb	θνήσκω
πλοῦτος	noun	πλοῦτος
οὐδὲν	adjective	οὐδείς
ὠφελεῖ	verb	ὠφελέω
.	SENT	.
ἦ	adverb	ἦ/ἦ#2
πολλὰ	adjective	πολύς
καὶ	conjunction	???/καί
παρόντα	verb	πάρειμι
καὶ	conjunction	???/καί
μέλλοντ̓	verb	<unknown>
ἔτι	adverb	ἔτι
ἤλγησ̓	verb	<unknown>
ἀκούσας	verb	ἀκούω/ἀκέω
βαρβάροισι	noun	βάρβαρος
πήματα	noun	πῆμα
.	SENT	.
ὦ	interjection	ὦ
δαῖμον	noun	δαίμων
,	SENT	,
ὥς	conjunction	ὥς/ὡς
με	pronoun	ἐγώ
πόλλ̓	noun	<unknown>
ἐσέρχεται	verb	εἰσέρχομαι
κακὰ	adjective	κακός
ἄλγη	noun	ἄλγος
,	SENT	,
μάλιστα	adverb	μάλα/μάλιστα
δ̓	verb	<unknown>
ἥδε	pronoun	ὅδε
συμφορὰ	noun	συμφορά
δάκνει	verb	δάκνω
,	SENT	,
ἀτιμίαν	noun	ἀτιμία
γε	particle	γε
παιδὸς	noun	παῖς
ἀμφὶ	preposition	ἀμφί
σώματι	noun	σῶμα
ἐσθημάτων	noun	ἔσθημα
κλύουσαν	verb	κλύω
,	SENT	,
ἥ	pronoun	ὁ/ὅς
νιν	pronoun	νιν
ἀμπέχει	verb	ἀμπέχω/ἀμφιχέω
.	SENT	.
ἀλλ̓	verb	<unknown>
εἶμι	verb	εἶμι
,	SENT	,
καὶ	conjunction	???/καί
λαβοῦσα	verb	λαμβάνω
κόσμον	noun	κόσμος
ἐκ	preposition	ἐκ
δόμων	noun	δόμος
ὑπαντιάζειν	verb	ὑπαντιάζω
παιδί	noun	παῖς
μου	pronoun	ἐγώ
πειράσομαι	verb	πειράζω/πειράω
.	SENT	.
οὐ	adverb	οὐκ/οὔπως/οὐ
γὰρ	adverb	γάρ
τὰ	article	ὁ/τίς
φίλτατ̓	adjective	<unknown>
ἐν	preposition	ἐν/εἰς
κακοῖς	adjective	κακός
προδώσομεν	verb	προδίδωμι
.	SENT	.
ὦ	interjection	ὦ
πόποι	interjection	πόποι
ἦ	adverb	ἦ/ἦ#2
μεγάλας	adjective	μέγας
ἀγαθᾶς	adjective	ἀγαθός
τε	conjunction	τε/ὅτε
πο	preposition	ἀπό
-	SENT	-
λισσονόμου	adjective	πολισσονόμος
βιοτᾶς	noun	βιοτή
ἐπεκύρσαμεν	verb	ἐπικύρω
,	SENT	,
εὖθ̓	verb	<unknown>
ὁ	article	ὁ
γηραιὸς	adjective	γηραιός
πανταρκὴς	adjective	πανταρκής
ἀκάκας	noun	ἀκάκης
ἄμαχος	adjective	ἄμαχος
βασιλεὺς	noun	βασιλεύς
ἰσόθεος	adjective	ἰσόθεος
Δαρεῖος	proper	Δαρεῖος
ἆρχε	verb	ἄρχω
χώρας	noun	χώρα
.	SENT	.
πρῶτα	adjective	πρότερος/πρῶτος
μὲν	particle	μέν
εὐδοκίμους	adjective	εὐδόκιμος
στρατιὰς	noun	στρατιά
ἀπε	unknown	unknown
-	SENT	-
φαινόμεθ̓	verb	<unknown>
,	SENT	,
ἠδὲ	conjunction	ἠδέ
νομίσματα	noun	νόμισμα
πύργινα	adjective	πύργινος
πάντ̓	adjective	<unknown>
ἐπηύθυνε	verb	ἐπευθύνω
,	SENT	,
νόστοι	noun	νόστος
δ̓	verb	<unknown>
ἐκ	preposition	ἐκ
πολέμων	noun	πόλεμος
ἀπόνους	adjective	ἄπονος
ἀπαθεῖς	adjective	ἀπαθής
ἀνέρας	noun	ἀνήρ
εὖ	adverb	εὖ
πράσσοντας	verb	πράσσω
ἆγον	verb	ἄγω
οἴκους	noun	οἶκος
.	SENT	.
ὅσσας	adjective	ὅσος
δ̓	adjective	<unknown>
εἷλε	verb	αἱρέω
πόλεις	noun	πολίς/πόλις/πόόλις
πόρον	noun	πόρος
οὐ	adverb	οὐκ/οὔπως/οὐ
διαβὰς	verb	διαβαίνω
Ἅλυος	noun	Ἅλυς
ποταμοῖο	noun	ποταμός
,	SENT	,
οὐ	adverb	οὐκ/οὔπως/οὐ
δ̓	verb	<unknown>
ἀφ̓	adjective	<unknown>
ἑστίας	noun	ἑστία
συθείς	verb	σεύω
,	SENT	,
οἷαι	adjective	οἷος#1/οἷος
Στρυμονίου	adjective	στρυμών
πελά	unknown	unknown
-	SENT	-
γους	noun	πέλαγος
Ἀχελωίδες	noun	̓ἀχελωίδες
εἰσὶ	verb	εἰμί#1/εἰμί
πάροικοι	adjective	πάροικος
Θρῃκίων	adjective	Θράκιος
ἐπαύλων	noun	ἔπαυλος
,	SENT	,
λίμνας	noun	λίμνη
τ̓	verb	<unknown>
ἔκτοθεν	adverb	ἔκτοθεν
αἳ	pronoun	ὁ/ὅς
κατὰ	preposition	κατά
χέρσον	noun	χέρσος
ἐληλαμέναι	verb	ἐλαύνω
πέρι	preposition	περί
πύργον	noun	πύργος
τοῦδ̓	adjective	<unknown>
ἄνακτος	noun	ἄναξ
ἄιον	verb	ἀίω
,	SENT	,
Ἕλλας	noun	Ἕλλη
τ̓	verb	<unknown>
ἀμφὶ	preposition	ἀμφί
πόρον	noun	πόρος
πλατὺν	adjective	πλατύς
εὐχόμεναι	verb	εὔχομαι
,	SENT	,
μυχία	adjective	μύχιος
τε	particle	τε/??/οὔτε
Προποντίς	noun	προποντίς
,	SENT	,
καὶ	conjunction	???/καί
στόμωμα	noun	στόμωμα
Πόντου	noun	Πόντος/πόντος
·	SENT	:
νᾶσοί	noun	νῆσος
θ̓	verb	<unknown>
αἳ	pronoun	ὁ/ὅς
κατὰ	preposition	κατά
πρῶν̓	noun	<unknown>
ἅλιον	adjective	ἅλιος
περίκλυστοι	adjective	περίκλυστος
τᾷδε	pronoun	ὅδε
γᾷ	noun	ὀργή/γῆ
προσήμεναι	verb	προσέω/πρόσημαι/προσῆμαι
οἵα	adjective	οἷος
Λέσβος	noun	Λέσβος/λέσβος
ἐλαι	unknown	unknown
-	SENT	-
όφυτός	adjective	ἐλαιοφυτός
τε	particle	τε/??/οὔτε
Σάμος	noun	σάμος
,	SENT	,
Χίος	noun	χίος
ἠδὲ	conjunction	ἠδέ
Πάρος	noun	Πάρος
,	SENT	,
Νάξος	noun	Νάξος
,	SENT	,
Μύκο	unknown	unknown
-	SENT	-
νος	noun	Μύκονος
,	SENT	,
Τήνῳ	noun	τήνος
τε	particle	τε/??/οὔτε
συνάπτουσ̓	verb	<unknown>
Ἀνδρος	noun	Ἄνδρος
ἀγχιγείτων	adjective	ἀγχιγείτων
,	SENT	,
καὶ	conjunction	???/καί
τὰς	article	ὁ
ἀγχιάλους	adjective	ἀγχίαλος
ἐκράτυνε	verb	κρατύνω
μεσάκτους	adjective	μέσακτος
,	SENT	,
Λῆμνον	noun	Λῆμνος/λῆμνος
,	SENT	,
Ἰκάρου	noun	Ἴκαρος
θ̓	adjective	<unknown>
ἕδος	noun	ἕδος
,	SENT	,
καὶ	conjunction	???/καί
Ῥόδον	noun	ῥόδον/Ῥόδος
ἠδὲ	conjunction	ἠδέ
Κνίδον	proper	Κνίδος
Κυπρίας	adjective	Κύπριος
τε	particle	τε/??/οὔτε
πόλεις	noun	πολίς/πόλις/πόόλις
,	SENT	,
Πάφον	noun	Πάφος/πάφος
,	SENT	,
ἠδὲ	conjunction	ἠδέ
Σόλους	noun	σόλος
,	SENT	,
Σαλαμῖνά	noun	Σαλαμίς
τε	particle	τε/??/οὔτε
,	SENT	,
τᾶς	article	ὁ
νῦν	adverb	νῦν#1/νῦν
ματρόπολις	noun	μητρόπολις
τῶνδ̓	adjective	<unknown>
αἰτία	noun	αἰτία
στεναγμῶν	noun	στεναγμός
.	SENT	.
καὶ	conjunction	???/καί
τὰς	article	ὁ
εὐκτεάνους	adjective	εὐκτέανος
κατὰ	preposition	κατά
κλῆρον	noun	κλῆρος
Ἰαόνιον	adjective	̓ἰαόνιος
πολυάνδρους	adjective	πολύανδρος
Ἑλλάνων	noun	Ἕλλην/῞ἕλλην
ἐκράτει	verb	κρατέω
σφετέραις	adjective	σφέτερος
φρεσίν	noun	φρήν
.	SENT	.
ἀκάματον	adjective	ἀκάματος
δὲ	particle	μηδέ/δέ/οὐδέ
παρῆν	verb	πάρειμι/πάρειμι#1
σθένος	noun	σθένος
ἀνδρῶν	noun	ἀνήρ
τευχηστήρων	noun	τευχηστήρ
παμμίκτων	adjective	πάμμικτος/παμμιγής
τ̓	verb	<unknown>
ἐπικούρων	noun	ἐπίκουρος
.	SENT	.
νῦν	adverb	νῦν#1/νῦν
δ̓	verb	<unknown>
οὐκ	adverb	οὐ
ἀμφιλόγως	adjective	ἀμφίλογος
θεότρεπτα	adjective	θεότρεπτος
τάδ̓	verb	<unknown>
αὖ	adverb	αὖ/αὗ
φέρομεν	verb	φέρω
πολέμοισι	noun	πόλεμος
δμαθέντες	verb	δαμάζω
μεγάλως	adverb	μέγας/μεγάλως
πλαγαῖσι	noun	πληγή
ποντίαισιν	adjective	πόντιος
.	SENT	.
ἰώ	interjection	ἰώ
,	SENT	,
δύστηνος	adjective	δύστηνος
ἐγὼ	pronoun	ἐγώ
στυγερᾶς	adjective	στυγερός
μοίρας	noun	μοῖρα
τῆσδε	pronoun	ὅδε
κυρήσας	verb	κυρέω
ἀτεκμαρτοτάτης	adjective	ἀτέκμαρτος
,	SENT	,
ὡς	conjunction	ὥς/ὡς
ὠμοφρόνως	adverb	ὠμόφρων
δαίμων	noun	δαίμων
ἐνέβη	verb	ἐμβαίνω
Περσῶν	noun	Πέρσης/Ρέρσης/πέρσης
γενεᾷ	noun	γενεά
·	SENT	:
τί	pronoun	τις/τίς/τὶς
πάθω	verb	πάσχω
τλήμων	adjective	τλήμων
;	SENT	;
λέλυται	verb	λύω
γὰρ	particle	γάρ
ἐμοὶ	pronoun	ἐμός/ἐγώ
γυίων	noun	γυῖον
ῥώμη	noun	ῥώμη
τήνδ̓	adjective	<unknown>
ἡλικίαν	noun	ἡλικία
ἐσιδόντ̓	verb	<unknown>
ἀστῶν	noun	ἀστός/ἀστή/ἄστυ
.	SENT	.
εἴθ̓	verb	<unknown>
ὄφελεν	verb	ὀφείλω
,	SENT	,
Ζεῦ	noun	Ζεύς/ζεύς
,	SENT	,
κἀμὲ	pronoun	ἐγώ
μετ̓	verb	<unknown>
ἀνδρῶν	noun	ἀνήρ
τῶν	article	ὁ/ὅς
οἰχομένων	verb	οἴχομαι
θανάτου	noun	θάνατος
κατὰ	preposition	κατά
μοῖρα	noun	μοῖρα
καλύψαι	verb	καλύπτω
.	SENT	.
ὀτοτοῖ	interjection	ὀτοτοῖ
,	SENT	,
βασιλεῦ	noun	βασιλεύς
,	SENT	,
στρατιᾶς	noun	στρατία/στρατιά
ἀγαθῆς	adjective	ἀγαθός
καὶ	conjunction	???/καί
περσονόμου	adjective	Περσονόμος
τιμῆς	noun	τιμὴ/τιμή
μεγάλης	adjective	μέγας
,	SENT	,
κόσμου	noun	κόσμος
τ̓	adjective	<unknown>
ἀνδρῶν	noun	ἀνήρ
,	SENT	,
οὓς	pronoun	ὁ/ὅς
νῦν	adverb	νῦν#1/νῦν
δαίμων	noun	δαίμων
ἐπέκειρεν	verb	ἐπικείρω
.	SENT	.
γᾶ	noun	γῆ
δ̓	adjective	<unknown>
αἰάζει	verb	αἰάζω
τὰν	article	ὁ
ἐγγαίαν	adjective	ἐγγαιος/ἔγγαιος
ἥβαν	noun	ἥβη
Ξέρξᾳ	noun	Ξέρξης
κταμέναν	verb	κτείνω/κτάομαι
Ἅιδου	noun	Ἅιδης/῞ᾅδης/ᾍδης
σάκτορι	noun	σάκτωρ
Περσᾶν	noun	Πέρσης/πέρσης
.	SENT	.
ᾁδοβάται	adjective	ᾁδοβάτης
γὰρ	particle	γάρ
πολλοὶ	adjective	πολύς
φῶτες	noun	φώς
,	SENT	,
χώρας	noun	χώρα
ἄνθος	noun	ἄνθος
,	SENT	,
τοξοδάμαντες	adjective	τοξόδαμνος
,	SENT	,
πάνυ	adverb	πάνυ
ταρφύς	adjective	ταρφύς
τις	pronoun	τις/τίς/τὶς
μυριὰς	noun	μυριάς
ἀνδρῶν	noun	ἀνήρ
,	SENT	,
ἐξέφθινται	verb	ἐκφθίνω
.	SENT	.
αἰαῖ	interjection	αἰαῖ
αἰαῖ	interjection	αἰαῖ
κεδνᾶς	adjective	κεδνός
ἀλκᾶς	noun	ἀλκή
.	SENT	.
Ἀσία	noun	Ἀσία/Ἀαία
δὲ	particle	μηδέ/δέ/οὐδέ
χθών	noun	χθών
,	SENT	,
βασιλεῦ	noun	βασιλεύς
γαίας	noun	γαῖα
,	SENT	,
αἰνῶς	adverb	αἰνός/αἰνῶς
αἰνῶς	adverb	αἰνός/αἰνῶς
ἐπὶ	preposition	ἐπί
γόνυ	noun	γόνυ
κέκλιται	verb	κλίνω
.	SENT	.
ὅδ̓	verb	<unknown>
ἐγώ	pronoun	ἐγώ
,	SENT	,
οἰοῖ	interjection	οἰοῖ/οἶ
,	SENT	,
αἰακτὸς	adjective	αἰακτός
μέλεος	adjective	μέλεος
γέννᾳ	noun	γέννα/γέννας
γᾷ	noun	ὀργή/γῆ
τε	particle	τε/??/οὔτε
πατρῴᾳ	adjective	πατρώιος/πατρῷος
κακὸν	adjective	κακός
ἄῤ	verb	<unknown>
ἐγενόμαν	verb	γίγνομαι
.	SENT	.
πρόσφθογγόν	adjective	πρόσφθογγος
σοι	pronoun	σοι/σύ
νόστου	noun	νόστος
τὰν	article	ὁ
κακοφάτιδα	noun	κακόφατις
βοάν	noun	βοή
,	SENT	,
κακομέλετον	adjective	κακομέλετος
ἰὰν	noun	ἰά
Μαριανδυνοῦ	noun	μαριανδυνός
θρηνητῆρος	noun	θρηνητήρ
πέμψω	verb	πέμπω
πέμψω	verb	πέμπω
,	SENT	,
πολύδακρυν	adjective	πολύδακρυς
ἰαχάν	noun	ἰαχή
.	SENT	.
ἵετ̓	verb	<unknown>
αἰανῆ	adjective	αἰανής
[καὶ]	conjunction	καί
πάνδυρτον	adjective	πάνδυρτος
δύσθροον	adjective	δύσθρους/δύσθροος
αὐδάν	noun	αὐδή
.	SENT	.
δαίμων	noun	δαίμων
γὰρ	particle	γάρ
ὅδ̓	verb	<unknown>
αὖ	adverb	αὖ/αὗ
μετάτροπος	adjective	μετάτροπος
ἐπ̓	verb	<unknown>
ἐμοί	pronoun	ἐγώ
.	SENT	.
ἥσω	verb	ἥδομαι/ἕζομαι/ἵημι
τοι	pronoun	σύ
τὰν	article	ὁ
πάνδυρτον	adjective	πάνδυρτος
,	SENT	,
σὰ	adjective	σός
πάθη	noun	πάθη/πάθος
τε	conjunction	τε/ὅτε
σέβων	verb	σέβω
ἁλίτυπά	adjective	ἁλίτυπος
τε	particle	τε/??/οὔτε
βάρη	noun	βᾶρις/βάρος
,	SENT	,
πόλεως	noun	πόλις
γέννας	noun	γέννα/γέννας
πενθητῆρος	noun	πενθητήρ
·	SENT	:
κλάγξω	verb	κλάζω
κλάγξω	verb	κλάζω
δὲ	adverb	δέ/οὐ
γόον	noun	γόος
ἀρίδακρυν	adjective	ἀρίδακρυς
.	SENT	.
Ἰάνων	noun	̓ἰάν
γὰρ	particle	γάρ
ἀπηύρα	verb	ἀπαυράω
,	SENT	,
Ἰάνων	noun	̓ἰάν
ναύφρακτος	adjective	ναύφρακτος
Ἄρης	noun	῎ἄρης/Ἄρης
ἑτεραλκὴς	adjective	ἑτεραλκής
νυχίαν	adjective	νύχιος
πλάκα	noun	πλάξ
κερσάμενος	verb	κείρω
δυσδαίμονά	adjective	δυσδαίμων
τ̓	verb	<unknown>
ἀκτάν	noun	ἀκτή
.	SENT	.
οἰοιοῖ	interjection	οἰοιοῖ
βόα	noun	βοῦς/βόα
καὶ	conjunction	???/καί
πάντ̓	adjective	<unknown>
ἐκπεύθου	verb	ἐκπεύθομαι
.	SENT	.
-	SENT	-
ποῦ	adverb	ποῦ/πού
δὲ	particle	μηδέ/δέ/οὐδέ
φίλων	adjective	φίλος
ἄλλος	adjective	ἄλλος
ὄχλος	noun	ὄχλος
,	SENT	,
ποῦ	adverb	ποῦ/πού
δέ	particle	δέ/οὐδέ
σοι	pronoun	σοι/σύ
παραστάται	noun	παραστάτης
,	SENT	,
οἷος	adjective	οἷος#1/οἷος
ἦν	verb	είμί/εἰμί#1/εἰμί/ἠμί
Φαρανδάκης	noun	Φαρανδάκης
,	SENT	,
Σούσας	noun	Σούσας
,	SENT	,
Πελάγων	noun	Πελάγων
,	SENT	,
[καὶ]	conjunction	καί
Δοτάμας	noun	Δοτάμας
,	SENT	,
ἠδ̓	verb	<unknown>
Ἀ	unknown	unknown
-	SENT	-
γδαβάτας	noun	Ἀγδαβάτας
,	SENT	,
Ψάμμις	noun	Ψάμμις
,	SENT	,
Σουσισκάνης	noun	Σουσισκάνης
τ̓	adjective	<unknown>
Ἀγβάτανα	noun	Ἀγβάτανα
λιπών	verb	λείπω
;	SENT	;
ὀλοοὺς	adjective	ὀλοός
ἀπέλειπον	verb	ἀπολιμπάνω/ἀπολείπω
Τυρίας	adjective	Τύριος
ἐκ	preposition	ἐκ
ναὸς	noun	ναῦς/ναός
ἔρροντας	verb	ἔρρω
ἐπ̓	verb	<unknown>
ἀκταῖς	noun	ἀκτή/ἀκτέα
Σαλαμινιάσι	adjective	Σαλαμινιάς
στυφελοῦ	adjective	στυφελός
θείνοντας	verb	θείνω
ἐπ̓	verb	<unknown>
ἀκτᾶς	noun	ἀκτή/ἀκτέα
.	SENT	.
οἰοιοῖ	interjection	οἰοιοῖ
,	SENT	,
βόα	verb	βοάω
·	SENT	:
ποῦ	adverb	ποῦ/πού
σοι	pronoun	σοι/σύ
Φαρνοῦχος	noun	Φαρνοῦχος
Ἀριόμαρδός	noun	Ἀριόμαρδός
τ̓	verb	<unknown>
ἀγαθός	adjective	ἀγαθός
,	SENT	,
ποῦ	adverb	ποῦ/πού
δὲ	particle	μηδέ/δέ/οὐδέ
Σευάλκης	noun	Σευάλκης
ἄναξ	noun	ἄναξ
,	SENT	,
ἢ	conjunction	ἤ
Λίλαιος	noun	Λίλαιος
εὐπάτωρ	noun	εὐπάτωρ
,	SENT	,
Μέμφις	noun	Μέμφις
,	SENT	,
Θάρυβις	noun	Θάρυβις
,	SENT	,
καὶ	conjunction	???/καί
Μασίστρας	noun	Μασίστρας
,	SENT	,
Ἀρτεμβάρης	noun	Ἀρτεμβάρας/Ἀρτεμβάρης
τ̓	adjective	<unknown>
ἠδ̓	verb	<unknown>
Ὑσταίχμας	noun	Ὑσταίχμας
;	SENT	;
τάδε	pronoun	ὅδε
σ̓	adjective	<unknown>
ἐπανερόμαν	verb	ἐπανέρομαι
.	SENT	.
ἰὼ	interjection	ἰώ
ἰώ	interjection	ἰώ
μοί	pronoun	ἐγώ
μοι	pronoun	τις/ἐγώ
τὰς	article	ὁ
ὠγυγίους	adjective	̓ὠγύγιος/ὠγύγιος
κατιδόντες	verb	κατεῖδον
στυγνὰς	adjective	στυγνός
Ἀθάνας	noun	Ἀθῆναι/Ἀθήνη
πάντες	adjective	πᾶς
ἑνὶ	adjective	εἷς
πιτύλῳ	noun	πίτυλος
,	SENT	,
ἐὴ	interjection	ἐή
ἐή	interjection	ἐή
,	SENT	,
τλάμονες	noun	τλήμων
ἀσπαίρουσι	verb	ἀσπαίρω
χέρσῳ	noun	χέρσος
.	SENT	.
ἦ	adverb	ἦ/ἦ#2
καὶ	conjunction	???/καί
τὸν	article	ὁ/τὸν
Περσᾶν	noun	Πέρσης/πέρσης
αὐτοῦ	pronoun	αὐτοός/αὐτός
τὸν	article	ὁ/τὸν
σὸν	adjective	σός
πιστὸν	adjective	πιστός
πάντ̓	adjective	<unknown>
ὀφθαλμὸν	noun	ὀφθαλμός
μυρία	adjective	μυρίος
μυρία	adjective	μυρίος
πεμπαστὰν	noun	πεμπαστής
Βατανώχου	noun	Βατάνωχος
παῖδ̓	adjective	<unknown>
Ἄλπιστον	noun	Ἄλπιστον
τοῦ	article	ὁ/ὅς/τὁ/ὀ
Σησάμα	noun	Σησάμης
τοῦ	article	ὁ/ὅς/τὁ/ὀ
Μεγαβάτα	noun	Μεγαβάτης
,	SENT	,
Πάρθον	noun	Πάρθος
τε	particle	τε/??/οὔτε
μέγαν	adjective	μέγας
τ̓	verb	<unknown>
Οἰβάρην	noun	Οἰβάρης
ἔλιπες	verb	λείπω
ἔλιπες	verb	λείπω
;	SENT	;
ὢ	interjection	ὦ
ὢ	interjection	ὦ
ὢ	interjection	ὦ
δᾴων	adjective	δάιος/δᾷος
.	SENT	.
Πέρσαις	noun	Πέρσης/πέρσης
ἀγαυοῖς	adjective	ἀγαυός
κακὰ	adjective	κακός
πρόκακα	adjective	πρόκακος
λέγεις	verb	λέγω
.	SENT	.
ἰὼ	interjection	ἰώ
ἰὼ	interjection	ἰώ
δῆτα	adverb	δῆτα
ἴυγγ̓	verb	<unknown>
ἀγαθῶν	adjective	ἀγαθός
ἑτάρων	noun	ἑταῖρος
μοι	pronoun	τις/ἐγώ
[ὑπομιμνήσκεις]	verb	ὑπομιμνήσκω
κινεῖς	verb	κινέω
ἄλαστα	adjective	ἄλαστος
στυγνὰ	adjective	στυγνός
πρόκακα	adjective	πρόκακος
λέγων	verb	λέγω
.	SENT	.
βοᾷ	verb	βοάω
βοᾷ	verb	βοάω
μοι	pronoun	τις/ἐγώ
μελέων	noun	μέλη/μέλος
ἔντοσθεν	preposition	ἔντοσθε/ἔντοσθεν
ἦτορ	noun	ἦτορ/ἤτορ
.	SENT	.
καὶ	conjunction	???/καί
μὴν	particle	μήν
ἄλλους	pronoun	ἄλλος
γε	adverb	γε
ποθοῦμεν	verb	ποθέω
,	SENT	,
Μάρδων	noun	Μάρδων/Μάρδος
ἀνδρῶν	noun	ἀνήρ
μυριοταγὸν	adjective	μυριοταγός
Ξάνθιν	noun	Ξάνθις
ἄρειόν	adjective	ἄρειος
τ̓	verb	<unknown>
Ἀγχάρην	noun	Ἀγχάρης
,	SENT	,
Δίαιξίν	noun	Δίαιξις
τ̓	adjective	<unknown>
ἠδ̓	verb	<unknown>
Ἀρσάκην	noun	Ἀρσάκης
ἱππιάνακτας	noun	ἱππιάναξ
,	SENT	,
Κηγδαδάταν	noun	Κηγδαδάτας
καὶ	conjunction	???/καί
Λυθίμναν	noun	Λυθίμναν
Τόλμον	noun	Τόλμος
τ̓	adjective	<unknown>
αἰχμᾶς	noun	αἰχμή
ἀκόρεστον	adjective	ἀκόρεστος
.	SENT	.
ἔταφον	verb	τέθηπα
ἔταφον	verb	τέθηπα
,	SENT	,
οὐκ	adverb	οὐ
ἀμφὶ	preposition	ἀμφί
σκηναῖς	noun	σκηνή
τροχηλάτοισιν	adjective	τροχήλατος
ὄπιθεν	adverb	ὄπισθεν
ἑπομένους	verb	ἕπομαι
.	SENT	.
βεβᾶσι	verb	βαίνω
γὰρ	particle	γάρ
τοίπερ	particle	τοι
ἀγρέται	noun	ἀγρέτης
στρατοῦ	noun	στρατός
.	SENT	.
βεβᾶσιν	verb	βαίνω
,	SENT	,
οἴ	interjection	οἰ/οἴ
,	SENT	,
νώνυμοι	adjective	νώνυμος
.	SENT	.
ἰὴ	interjection	ἰή
ἰή	interjection	ἰή
,	SENT	,
ἰὼ	interjection	ἰώ
ἰώ	interjection	ἰώ
.	SENT	.
ἰὼ	interjection	ἰώ
ἰώ	interjection	ἰώ
,	SENT	,
δαίμονες	noun	δαίμων
,	SENT	,
ἔθεθ̓	verb	<unknown>
ἄελπτον	adjective	ἄελπτος
κακὸν	adjective	κακός
διαπρέπον	verb	διαπρέπω
,	SENT	,
οἷον	adjective	οἷος
δέδορκεν	verb	δέρκομαι
Ἄτα	noun	ἄτη
.	SENT	.
πεπλήγμεθ̓	verb	<unknown>
οἵᾳ	adjective	οἷος
δἰ	verb	<unknown>
αἰῶνος	noun	αἰών
τύχᾳ	noun	τύχη
·	SENT	:
πεπλήγμεθ̓	verb	<unknown>
·	SENT	:
εὔδηλα	adjective	εὔδηλος
γάρ	particle	γάρ
·	SENT	:
νέᾳ	adjective	νέος/νέα
νέᾳ	adjective	νέος/νέα
δύᾳ	noun	δύη
δύᾳ	noun	δύη
.	SENT	.
κύρσαντες	verb	κυρέω
οὐκ	adverb	οὐ
εὐτυχῶς	adverb	εὐτυχής
Ἰάνων	noun	̓ἰάν
ναυβατᾶν	noun	ναυβάτης
.	SENT	.
δυσπόλεμον	adjective	δυσπόλεμος
δὴ	particle	δή
γένος	noun	γένος
τὸ	article	ὁ
Περσᾶν	noun	Πέρσης/πέρσης
.	SENT	.
πῶς	adverb	πως/πῶς
δ̓	verb	<unknown>
οὔ	adverb	οὔπως/οὔτι/οὔτε/οὐ
;	SENT	;
στρατὸν	noun	στρατός
μὲν	particle	μέν
τοσοῦ	unknown	unknown
-	SENT	-
τον	article	ὁ
τάλας	adjective	τάλας
πέπληγμαι	verb	πλήσσω
.	SENT	.
τί	pronoun	τις/τίς/τὶς
δ̓	verb	<unknown>
οὔκ	adverb	οὐ
;	SENT	;
ὄλωλεν	verb	ὄλλυμι
μεγάλως	adverb	μέγας/μεγάλως
τὰ	article	ὁ/τίς
Περσᾶν	noun	Πέρσης/πέρσης
.	SENT	.
ὁρᾷς	verb	ὁράω
τὸ	article	ὁ
λοιπὸν	adjective	λοιπός
τόδε	pronoun	ὅδε
τᾶς	article	ὁ
ἐμᾶς	adjective	ἐμός
στολᾶς	noun	στολή
;	SENT	;
ὁρῶ	verb	ὁράω
ὁρῶ	verb	ὁράω
.	SENT	.
τόνδε	pronoun	ὅδε
τ̓	verb	<unknown>
ὀιστοδέγμονα	adjective	ὀιστοδέγμων
-	SENT	-
τί	pronoun	τις/τίς/τὶς
τόδε	pronoun	ὅδε
λέγεις	verb	λέγω
σεσωσμένον	verb	σώζω
;	SENT	;
θησαυρὸν	noun	θησαυρός
βελέεσσιν	noun	βέλος
;	SENT	;
βαιά	adjective	βαιός
γ̓	verb	<unknown>
ὡς	conjunction	ὥς/ὡς
ἀπὸ	preposition	ἀπό
πολλῶν	adjective	πολύς
.	SENT	.
ἐσπανίσμεθ̓	verb	<unknown>
ἀρωγῶν	adjective	ἀρωγός/ἀρωγή
.	SENT	.
Ἰάνων	noun	̓ἰάν
λαὸς	noun	λαός
οὐ	adverb	οὐκ/οὔπως/οὐ
φυγαίχμας	noun	φυγαίχμης
.	SENT	.
ἀγανόρειος	noun	ἀγήνωρ
·	SENT	:
κατεῖ-	unknown	unknown
δον	verb	κατεῖδον
δὲ	adverb	δέ/οὐ
πῆμ̓	verb	<unknown>
ἄελπτον	adjective	ἄελπτος
.	SENT	.
τραπέντα	verb	τέρπω/τρέπω
ναύφρακτον	adjective	ναύφρακτος
ἐρεῖς	verb	λέγω/ἐρῶ/ἐρέω
ὅμιλον	noun	ὅμιλος
;	SENT	;
πέπλον	noun	πεπλος/πέπλος
δ̓	adjective	<unknown>
ἐπέρρηξ̓	verb	<unknown>
ἐπὶ	preposition	ἐπί
συμφορᾷ	noun	συμφορά
κακοῦ	adjective	κακός/κακός·
.	SENT	.
παπαῖ	interjection	παπαῖ
παπαῖ	interjection	παπαῖ
.	SENT	.
καὶ	conjunction	???/καί
πλέον	adjective	πλέος/πλείων/πλέως/πολύς
ἢ	conjunction	ἤ
παπαῖ	interjection	παπαῖ
μὲν	adverb	μέν
οὖν	adverb	οὖν
.	SENT	.
δίδυμα	adjective	δίδυμος
γάρ	particle	γάρ
ἐστι	verb	εἰμί#1/εἰμί
καὶ	conjunction	???/καί
τριπλᾶ	adjective	τριπλόος
-	SENT	-
λυπρά	adjective	λυπρός
,	SENT	,
χάρματα	noun	χάρμα
δ̓	verb	<unknown>
ἐχθροῖς	adjective	ἐχθρός
.	SENT	.
καὶ	conjunction	???/καί
σθένος	noun	σθένος
γ̓	adjective	<unknown>
ἐκολούσθη	verb	κολούω
-	SENT	-
γυμνός	adjective	γυμνός
εἰμι	verb	εἰμί#1/εἰμί
προπομπῶν	adjective	προπομπός
.	SENT	.
φίλων	adjective	φίλος
ἄταισι	noun	ἄτη
ποντίαισιν	adjective	πόντιος
·	SENT	:
δίαινε	verb	διαίνω
δίαινε	verb	διαίνω
πῆμα	noun	πῆμα
·	SENT	:
πρὸς	preposition	πρός
δόμους	noun	δόμος
δ̓	adjective	<unknown>
ἴθι	verb	εἶμι#2/εἶμι
.	SENT	.
αἰαῖ	interjection	αἰαῖ
αἰαῖ	interjection	αἰαῖ
,	SENT	,
δύα	noun	δύη
δύα	noun	δύη
.	SENT	.
βόα	verb	βοάω
νυν	adverb	νῦν#1/νῦν/νυν#2
ἀντίδουπά	adjective	ἀντίδουπος
μοι	pronoun	τις/ἐγώ
.	SENT	.
δόσιν	noun	δόσις
κακὰν	adjective	κακός
κακῶν	adjective	κακός
κακοῖς	adjective	κακός
.	SENT	.
ἴυζε	verb	ἰύζω
μέλος	noun	μέλος
ὁμοῦ	adverb	ὁμοῦ
τιθείς	verb	τίθημι
.	SENT	.
ὀτοτοτοτοῖ	interjection	ὀτοτοῖ
.	SENT	.
βαρεῖά	adjective	βαρύς
γ̓	verb	<unknown>
ἅδε	pronoun	ὅδε
συμφορά	noun	συμφορά
.	SENT	.
οἲ	interjection	ὄι/οἰ/οἴ
μάλα	adverb	μάλα
καὶ	conjunction	???/καί
τόδ̓	noun	<unknown>
ἀλγῶ	verb	ἀλγέω
.	SENT	.
ἔρεσσ̓	verb	<unknown>
ἔρεσσε	verb	ἐρέσσω
καὶ	conjunction	???/καί
στέναζ̓	verb	<unknown>
ἐμὴν	adjective	ἐμός
χάριν	noun	χάρις
.	SENT	.
διαίνομαι	verb	διαίνω
γοεδνὸς	adjective	γοερός
ὤν	verb	εἰμί#1/εἰμί
.	SENT	.
βόα	verb	βοάω
νυν	adverb	νῦν#1/νῦν/νυν#2
ἀντίδουπά	adjective	ἀντίδουπος
μοι	pronoun	τις/ἐγώ
.	SENT	.
μέλειν	verb	μέλω
πάρεστι	verb	πάρειμι/πάρειμι#1
,	SENT	,
δέσποτα	noun	δεσπότης
.	SENT	.
ἐπορθίαζέ	verb	ἐπορθιάζω
νυν	adverb	νῦν#1/νῦν/νυν#2
γόοις	noun	γόος
.	SENT	.
ὀτοτοτοτοῖ	interjection	ὀτοτοῖ
.	SENT	.
μέλαινα	adjective	μέλας
δ̓	adjective	<unknown>
ἀμμεμείξεται	verb	ἀναμίγνυμι
,	SENT	,
οἴ	interjection	οἰ/οἴ
,	SENT	,
στονόεσσα	adjective	στονόεις
πλαγά	noun	πληγή
.	SENT	.
καὶ	conjunction	???/καί
στέρν̓	adjective	<unknown>
ἄρασσε	verb	ἀράζω/ἀράσσω
κἀπιβόα	verb	ἐπιβοάω
τὸ	article	ὁ
Μύσιον	adjective	μύσιος/Μύσιος
.	SENT	.
ἄνἰ	verb	<unknown>
ἄνια	adjective	ἄνιος
.	SENT	.
καί	conjunction	καί
μοι	pronoun	τις/ἐγώ
γενείου	noun	γένειον
πέρθε	verb	πέρθω
λευκήρη	adjective	λευκήρης
τρίχα	noun	θρίξ
.	SENT	.
ἄπριγδ̓	adjective	<unknown>
ἄπριγδα	adverb	ἄπριγδα
μάλα	adverb	μάλα
γοεδνά	adjective	γοερός/γοεδνός
.	SENT	.
ἀύτει	verb	ἀυτέω
δ̓	verb	<unknown>
ὀξύ	adjective	ὀξύς
.	SENT	.
καὶ	conjunction	???/καί
τάδ̓	verb	<unknown>
ἔρξω	verb	ἔρδω/ἔργω
.	SENT	.
πέπλον	noun	πεπλος/πέπλος
δ̓	adjective	<unknown>
ἔρεικε	verb	ἐρέικω
κολπίαν	noun	κολπίας
ἀκμῇ	noun	ἀκμή
χερῶν	noun	χείρ
.	SENT	.
ἄνἰ	verb	<unknown>
ἄνια	adjective	ἄνιος
.	SENT	.
καὶ	conjunction	???/καί
ψάλλ̓	verb	<unknown>
ἔθειραν	noun	ἔθειρα
καὶ	conjunction	???/καί
κατοίκτισαι	verb	κατοικτίζω
στρατόν	noun	στρατός
.	SENT	.
ἄπριγδ̓	adjective	<unknown>
ἄπριγδα	adverb	ἄπριγδα
μάλα	adverb	μάλα
γοεδνά	adjective	γοερός/γοεδνός
.	SENT	.
διαίνου	verb	διαίνω
δ̓	adjective	<unknown>
ὄσσε	noun	ὄσσε/ὄσσα
.	SENT	.
τέγγομαί	verb	τέγγω
τοι	particle	τοι
.	SENT	.
βόα	verb	βοάω
νυν	adverb	νῦν#1/νῦν/νυν#2
ἀντίδουπά	adjective	ἀντίδουπος
μοι	pronoun	τις/ἐγώ
.	SENT	.
οἰοῖ	interjection	οἰοῖ/οἶ
οἰοῖ	interjection	οἰοῖ/οἶ
.	SENT	.
αἰακτὸς	adjective	αἰακτός
ἐς	preposition	εἰς
δόμους	noun	δόμος
κίε	verb	κίω
.	SENT	.
ἰὼ	interjection	ἰώ
ἰώ	interjection	ἰώ
,	SENT	,
[Περσὶς	noun	Περσίς
αἶα	noun	γαῖα/αἶα
δύσβατος]	adjective	δύσβατος
.	SENT	.
ἰὼ	interjection	ἰώ
ἰώ	interjection	ἰώ
,	SENT	,
Περσὶς	noun	Περσίς
αἶα	noun	γαῖα/αἶα
δύσβατος	adjective	δύσβατος
.	SENT	.
ἰὴ	interjection	ἰή
ἰὴ	interjection	ἰή
τρισκάλμοισιν	adjective	τρίσκαλμος
,	SENT	,
ἰὴ	interjection	ἰή
ἰή	interjection	ἰή
,	SENT	,
βάρισιν	noun	βᾶρις
ὀλόμενοι	adjective	οὐλόμενος
.	SENT	.
πέμψω	verb	πέμπω
τοί	particle	τοι
σε	pronoun	σύ
δυσθρόοις	adjective	δύσθρους/δύσθροος
γόοις	noun	γόος
.	SENT	.
